ISO639-3	ISO15924-Main	Wiki-aux	SIL-aux	Lrec2800-aux	SIL2-aux
aaa	Latn				
aab	Latn				
aac	Latn				
aad	Latn				
aae	Latn, Grek				
aaf	Mlym, Arab			Latn	
aag	Latn				
aah	Latn				
aai	Latn				
aak	Latn				
aal	Latn				
aan	Latn				
aao	Arab				
aap	Latn				
aaq	Latn				
aar	Ethi, Latn		Arab		
aas	Latn				
aat	Grek, Latn				
aau	Latn				
aaw	Latn				
aax	Latn				
aaz	Latn				
aba	Latn				
abb	Latn				
abc	Latn				
abd	Latn				
abe	Latn				
abf	Latn	Zxxx			
abg	Latn				
abh	Arab				
abi	Latn				
abj					
abk	Cyrl, Latn, Geor	Arab			
abl	Rjng, Latn				
abm	Latn				
abn	Latn				
abo	Latn				
abp	Latn				
abq	Cyrl, Latn				
abr	Latn				
abs	Latn				
abt	Latn				
abu	Latn				
abv	Arab	Latn			
abw	Latn				
abx	Latn				
aby	Latn				
abz	Latn				
aca	Latn				
acb	Latn				
acd	Latn				
ace	Arab, Latn				
acf	Latn				
ach	Latn				
aci					
ack					
acl					
acm	Arab				
acn	Latn				
acp	Latn				
acq	Arab				
acr	Latn				
acs	Latn				
act	Latn				
acu	Latn				
acv	Latn				
acw	Arab				
acx	Arab				
acy	Arab, Latn, Grek				
acz	Latn				
ada	Latn				
adb	Latn				
add	Latn				
ade	Latn				
adf	Arab				
adg	Latn				
adh	Latn				
adi	Latn		Tibt		
adj	Latn				
adl	Latn				
adn	Latn				
ado	Latn				
adp					
adq	Latn				
adr	Latn				
ads	Latn, Zxxx				
adt	Latn				
adu	Latn				
adw	Latn				
adx	Tibt				
ady	Arab, Cyrl, Latn				
adz	Latn				
aea	Latn				
aeb	Arab, Latn				Hebr
aec	Arab				
aed	Zxxx				
aee	Arab				
aek	Latn				
ael	Latn				
aem	Latn				
aen	Zxxx				
aeq	Arab				
aer	Latn				
aes					
aeu	Latn				
aew	Latn				
aey	Latn				
aez	Latn				
afb	Arab				
afd	Latn				
afe	Latn				
afg	Zxxx				
afh	Latn				
afi	Latn				
afk	Latn				
afn	Latn				
afo	Latn				
afp	Latn				
afr	Arab, Latn, Brai				
afs	Latn				
aft					
afu	Latn				
afz	Latn				
aga	Latn				
agb	Latn				
agc	Latn				
agd	Latn				
age	Latn				
agf	Latn				
agg	Latn				
agh	Latn				
agi	Deva				
agj	Arab, Ethi				
agk	Latn				
agl	Latn				
agm	Latn				
agn	Latn				
ago	Latn				
agq	Latn				
agr	Latn				
ags	Latn				
agt	Latn				
agu	Latn				
agv	Latn				
agw	Latn				
agx	Cyrl				
agy	Latn				
agz	Latn				
aha	Latn				
ahb	Latn				
ahg	Ethi				
ahh	Latn				
ahi	Latn				
ahk	Latn		Mymr, Thai		
ahl	Latn				
ahm	Latn				
ahn	Latn				
aho	Ahom				
ahp	Latn				
ahr	Deva				
ahs	Latn				
aht	Latn				
aia	Latn				
aib	Arab				
aic	Latn				
aid	Latn				
aie	Latn				
aif	Latn				
aig	Latn				
aih					
aii	Syrn, Syrc		Cyrl		Elym
aij	Hebr				
aik	Latn				
ail	Latn				
aim	Latn	Mtei			
ain	Kana, Latn				
aio	Mymr				
aip	Latn				
aiq	Arab				
air	Latn				
ais					
ait	Latn				
aiw	Ethi, Latn		Arab		
aix	Latn				
aiy	Latn				
aja	Latn				
ajg	Latn				
aji	Latn				
ajn	Latn				
ajp	Arab				
ajs	Zxxx				
ajt	Arab, Hebr				
aju	Arab				
ajw	Latn				
ajz	Latn			Beng	
aka	Latn		Arab		
akb	Latn, Batk				
akc	Latn				
akd	Latn				
ake	Latn				
akf	Latn				
akg	Latn				
akh	Latn				
aki	Latn				
akj					
akk	Xsux				
akl	Latn	Tglg			
akm					
ako	Latn				
akp	Latn				
akq	Latn				
akr	Latn				
aks	Latn	Brai			
akt	Latn				
aku	Latn				
akv	Cyrl				
akw	Latn				
akx					
aky					
akz	Latn				
ala	Latn				
alc	Latn				
ald	Latn				
ale	Cyrl, Latn, Cyrs				
alf	Latn				
alh	Latn				
ali	Latn				
alj	Latn				
alk	Laoo	Khom			
all	Mlym				
alm	Latn				
aln	Latn, Brai				
alo	Latn				
alp	Latn				
alq	Latn				
alr	Cyrl, Latn				
als	Latn				
alt	Cyrl, Cyrs		Mong		
alu	Latn				
alw	Ethi				
alx	Latn				
aly	Latn				
alz	Latn				
ama	Latn				
amb	Latn				
amc	Latn				
ame	Latn				
amf	Latn		Ethi		
amg	Latn				
amh	Ethi, Brai		Arab	Latn	
ami	Latn				
amj	Latn				
amk	Latn				
aml					
amm	Latn				
amn	Latn				
amo	Latn				
amp	Latn				
amq	Latn				
amr	Latn				
ams	Jpan				
amt	Latn				
amu	Latn				
amv	Latn				
amw	Arab, Syrj, Latn, Armi, Syrc				
amx	Latn				
amy	Latn				
amz	Latn				
ana	Latn				
anb	Latn				
anc	Latn				
and	Latn				
ane	Latn				
anf	Latn				
ang	Latn, Runr				
anh	Latn				
ani	Cyrl				
anj	Latn				
ank	Latn				
anl	Latn				
anm	Latn				
ann	Latn				
ano	Latn				
anp	Deva				
anq	Deva, Latn	Zxxx			
anr	Deva				
ans	Latn				
ant	Latn				
anu	Ethi		Arab, Latn		
anv	Latn				
anw	Latn				
anx	Latn				
any	Latn				
anz	Latn				
aoa	Latn				
aob	Latn				
aoc	Latn				
aod	Latn				
aoe	Latn				
aof	Latn				
aog	Latn				
aoh	Latn				
aoi	Latn				
aoj	Latn				
aok	Latn				
aol	Latn				
aom	Latn				
aon	Latn				
aor	Latn				
aos	Latn				
aot	Beng, Latn				
aou					
aox	Latn				
aoz	Latn				
apb	Latn				
apc	Arab, Latn	Hebr			
apd	Arab		Latn		
ape	Latn				
apf	Latn				
apg	Latn				
aph	Deva				
api	Latn				
apj	Latn				
apk	Latn				
apl	Latn				
apm	Latn				
apn	Latn				
apo	Latn				
app	Latn	Avoiuli			
apq					
apr	Latn				
aps	Latn				
apt	Latn				
apu	Latn				
apv	Latn				
apw	Latn				
apx	Latn				
apy	Latn				
apz	Latn				
aqc	Cyrl				
aqd	Latn				
aqg	Latn				
aqk	Latn				
aqm	Latn				
aqn	Latn				
aqp					
aqr	Latn				
aqt	Latn				
aqz	Latn				
ara	Arab, Latn	Hebr, Grek	Syrc, Brai		
arb	Arab				
arc	Hatr, Nbat, Armi, Syrc, Palm				
ard	Latn				
are	Latn				
arg	Latn				
arh	Latn				
ari	Latn				
arj	Latn				
ark	Latn				
arl	Latn				
arn	Latn				
aro	Latn				
arp	Latn				
arq	Arab				
arr	Latn				
ars	Arab				
aru	Latn				
arv					
arw	Latn				
arx	Latn				
ary	Arab				
arz	Arab, Brai				
asa	Latn				
asb	Latn				
asc	Latn				
ase	Sgnw, Zxxx	si5s, ASL-phabet, Stokoe notation			
asf	Zxxx				
asg	Latn				
ash	Latn				
asi	Latn				
asj	Latn				
ask	Arab	Latn			
asl	Latn				
asm	Beng, Latn	Ahom, Brai		Deva	
asn	Latn				
aso	Latn				
asp	Zxxx				
asq	Zxxx				
asr	Deva				
ass	Latn				
ast	Latn				
asu	Latn				
asv	Latn				
asw	Zxxx				
asx	Latn				
asy	Latn				
asz	Latn				
ata	Latn				
atb	Latn		Lisu		
atc	Latn				
atd	Latn				
ate	Latn				
atg	Latn				
ati	Latn				
atj	Latn				
atk	Latn				
atl	Latn				
atm	Latn				
atn	Arab				
ato	Latn				
atp	Latn				
atq	Latn				
atr	Latn				
ats	Latn				
att	Latn				
atu	Latn				
atv	Cyrl				
atw	Latn				
atx	Latn				
aty	Latn				
atz	Latn				
aua	Latn				
aub					
auc	Latn				
aud	Latn				
aug	Latn				
auh	Latn				
aui	Latn				
auj	Arab, Tfng, Latn				
auk	Latn				
aul	Latn				
aum	Latn				
aun	Latn				
auo	Latn				
aup	Latn				
auq	Latn				
aur	Latn				
aut	Latn				
auu	Latn				
auw	Latn				
aux	Latn				
auy	Latn				
auz	Arab				
ava	Cyrl	Latn, Arab			
avb	Latn				
avd	Arab				
ave	Gujr, Arab, Avst	Deva			
avi	Latn				
avk	Latn				
avl	Arab				
avm	Latn				
avn	Latn				
avo	Latn				
avs	Latn				
avt	Latn				
avu	Latn				
avv	Latn				
awa	Deva, Latn	Kthi, Arab			
awb	Latn				
awc	Latn				
awe	Latn				
awg	Latn				
awh	Latn				
awi	Latn				
awk	Latn				
awm	Latn				
awn	Ethi			Latn	
awo	Latn				
awr	Latn				
aws	Latn				
awt	Latn				
awu	Latn				
awv	Latn				
aww	Latn				
awx	Latn				
awy	Latn				
axb	Latn				
axe	Latn				
axg	Latn				
axk	Latn				
axl	Latn				
axm	Armn				
axx	Latn				
aya	Latn				
ayb	Latn				
ayc	Latn				
ayd	Latn				
aye	Latn				
ayg	Latn				
ayh	Arab				
ayi	Latn				
ayk	Latn				
ayl	Arab				
aym	Latn				
ayn	Arab				
ayo	Latn				
ayp	Arab				
ayq	Latn				
ayr	Latn				
ays	Latn				
ayt	Latn				
ayu	Latn				
ayy	Latn				
ayz	Latn				
aza					
azb	Arab	Geor	Cyrl, Latn		
azd	Latn				
aze	Arab, Cyrl, Latn	Geor	Brai		
azg	Latn				
azj	Latn				
azm	Latn				
azn	Latn				
azo	Latn				
azr					
azt	Latn				
azz	Latn				
baa	Latn				
bab	Latn				
bac	Latn	Zxxx			
bae	Latn				
baf	Latn				
bag	Latn				
bah	Latn				
baj	Latn				
bak	Cyrl		Arab		
bal	Arab, Latn				
bam	Arab, Latn, Nkoo				
ban	Bali, Latn, Java				
bao	Latn				
bap	Deva	Kirat Rai			
bar	Latn				
bas	Latn				
bau	Latn				
bav	Latn				
baw	Latn				
bax	Bamu, Latn				
bay	Latn				
bba	Latn				
bbb	Latn				
bbc	Latn, Batk				
bbd	Latn				
bbe	Latn				
bbf	Latn				
bbg	Latn				
bbh					
bbi	Latn				
bbj	Latn				
bbk	Latn				
bbl	Geor				
bbm	Latn				
bbn	Latn				
bbo	Latn				
bbp	Latn				
bbq	Latn				
bbr	Latn				
bbs	Latn				
bbt	Latn				
bbu	Latn				
bbv	Latn				
bbw	Latn				
bbx	Latn				
bby	Latn				
bbz	Latn				
bca	Hani, Latn	Bowen			
bcb	Latn				
bcc	Arab				
bcd	Latn				
bce	Latn				
bcf	Latn				
bcg	Latn	Zxxx			
bch	Latn				
bci	Latn				
bcj	Latn				
bck	Latn				
bcl	Latn	Brai			
bcm	Latn				
bcn	Latn				
bco	Latn				
bcp	Latn				
bcq	Ethi, Latn				
bcr	Latn				
bcs	Latn				
bct	Latn				
bcu	Latn				
bcv	Latn				
bcw	Latn				
bcy	Latn				
bcz	Latn				
bda	Latn				
bdb	Latn				
bdc	Latn				
bdd	Latn				
bde	Latn				
bdf	Latn				
bdg	Latn				
bdh	Latn				
bdi	Latn				
bdj	Latn				
bdk	Latn				
bdl	Latn				
bdm	Latn				
bdn	Latn				
bdo	Latn				
bdp	Latn				
bdq	Latn				
bdr	Latn				
bds	Latn				
bdt	Latn				
bdu	Latn				
bdv	Orya				
bdw	Latn				
bdx	Latn				
bdy	Latn				
bdz	Arab				
bea	Latn		Cans		
beb	Latn				
bec	Latn				
bed	Latn				
bee	Deva				
bef	Latn				
beg					
beh	Latn				
bei	Latn				
bej	Arab, Latn				
bek	Latn				
bel	Arab, Cyrl, Latn, Brai				
bem	Latn, Brai				
ben	Beng, Brai		Newa	Latn	
beo	Latn				
bep	Latn				
beq	Latn				
ber	Latn				
bes	Latn				
bet	Latn				
beu	Latn				
bev	Latn				
bew	Latn				
bex	Latn		Arab		
bey	Latn				
bez	Latn				
bfa	Latn		Arab		
bfb	Deva				
bfc	Latn	Bowen			
bfd	Latn				
bfe	Latn				
bff	Latn				
bfg	Latn				
bfh	Latn				
bfi	Zxxx	Sgnw			
bfj	Latn				
bfk	Zxxx				
bfl	Latn				
bfm	Latn				
bfn	Latn				
bfo	Latn				
bfp	Latn				
bfq	Knda, Taml, Latn	Mlym			
bfr					
bfs	Hani, Latn	Bowen			
bft	Arab, Tibt	Balti		Latn	
bfu	Takr, Tibt				
bfw	Orya				
bfx	Latn				
bfy	Deva			Latn	
bfz	Deva	Takr			
bga	Latn				
bgb	Latn				
bgc	Deva	Arab		Latn	
bgd	Deva	Gujr			
bge					
bgf	Latn				
bgg	Latn				
bgi	Latn				
bgj	Latn				
bgk					
bgl					
bgm					
bgn	Arab		Cyrl		
bgo	Latn				
bgp	Arab			Latn	
bgq	Deva, Arab			Latn	
bgr	Latn				
bgs	Latn				
bgt	Latn				
bgu	Latn				
bgv	Latn				
bgw	Deva				
bgx	Cyrl, Latn, Grek				
bgy	Latn				
bgz	Latn				
bha	Deva				
bhb	Deva, Gujr			Latn, Guru	
bhc	Latn				
bhd	Deva, Arab, Takr				
bhe	Arab				
bhf	Latn				
bhg	Latn				
bhh	Cyrl, Hebr, Latn				
bhi	Deva				
bhj	Deva				
bhl	Latn				
bhm	Arab				
bhn	Syrc				
bho	Deva, Kthi			Latn	
bhp	Latn	Bugi			
bhq	Latn				
bhr	Latn	Arab, Brai			
bhs	Latn				
bht	Deva, Takr		Latn		
bhu	Deva				
bhv	Latn				
bhw	Latn				
bhx					
bhy	Latn				
bhz	Latn				
bia	Latn				
bib	Latn				
bid	Latn				
bie	Latn				
bif	Latn				
big	Latn				
bih	Deva				
bii					
bik	Latn		Brai		
bil	Latn				
bim	Latn	Brai			
bin	Latn				
bio	Latn				
bip	Latn				
biq	Latn				
bir	Latn				
bis	Latn	Avoiuli			
bit	Latn				
biu	Latn				
biv	Latn				
biw	Latn				
bix					
biy	Deva				
biz	Latn				
bja	Latn				
bjb	Latn				
bjc	Latn				
bje					
bjf	Syrc				
bjg	Latn				
bjh	Latn				
bji	Ethi		Latn		
bjj	Deva			Latn	
bjk	Latn				
bjl	Latn				
bjm	Arab				
bjn	Arab, Latn				
bjo	Latn				
bjp	Latn				
bjq					
bjr	Latn				
bjs	Latn				
bjt	Latn		Arab		
bju	Latn				
bjv	Latn				
bjw	Latn				
bjx	Latn				
bjy	Latn				
bjz	Latn				
bka	Latn				
bkc	Latn				
bkd	Latn				
bkf	Latn				
bkg	Latn				
bkh	Latn				
bki	Latn				
bkj	Tibt, Latn				
bkk	Zzzz				
bkl	Latn				
bkm	Latn				
bkn	Latn				
bko	Latn				
bkp	Latn				
bkq	Latn				
bkr	Latn				
bks	Latn				
bkt	Latn				
bku	Latn, Buhd		Hano		
bkv	Latn				
bkw	Latn				
bkx	Latn				
bky	Latn				
bkz	Latn				
bla	Cans, Latn				
blb	Latn				
blc	Latn				
bld	Latn				
ble	Latn				
blf	Latn				
blg					
blh	Latn				
bli	Latn				
blj	Latn				
blk	Mymr	Brai			
bll					
blm	Latn				
bln	Latn				
blo	Latn				
blp	Latn				
blq	Latn				
blr	Tale, Latn	Lana	Thai		
bls	Latn				
blt	Tavt, Laoo, Latn				
blu					
blv	Latn				
blw	Latn				
blx	Latn				
bly	Latn				
blz	Latn				
bma	Latn				
bmb	Latn				
bmc	Latn				
bmd	Latn				
bme	Latn				
bmf	Latn				
bmg	Latn				
bmh	Latn				
bmi	Latn				
bmj	Deva				
bmk	Latn				
bml	Latn				
bmm	Latn	Arab, Brai			
bmn	Latn				
bmo	Latn				
bmp	Latn				
bmq	Latn				
bmr	Latn				
bms	Latn				
bmt					
bmu	Latn				
bmv	Latn				
bmw	Latn				
bmx	Latn				
bmz	Latn				
bna	Latn				
bnb	Latn				
bnc	Latn				
bnd	Latn				
bne	Latn				
bnf	Latn				
bng	Latn				
bni	Latn				
bnj	Latn				
bnk	Latn				
bnl					
bnm	Latn				
bnn	Latn				
bno	Latn	Tglg			
bnp	Latn				
bnq	Latn				
bnr	Latn				
bns	Deva			Latn	
bnu	Latn				
bnv	Latn				
bnw	Latn				
bnx	Latn				
bny	Latn				
bnz	Latn				
boa	Latn				
bob	Latn				
bod	Marc, Tibt, Latn	Brai	Phag		
boe	Latn				
bof	Latn				
bog	Zxxx				
boh	Latn				
boi					
boj	Latn				
bok	Latn				
bol	Latn				
bom	Latn				
bon	Latn				
boo	Latn				
bop	Latn				
boq	Latn				
bor	Latn				
bos	Arab, Cyrl, Latn	Brai			
bot	Latn				
bou	Latn				
bov	Latn				
bow	Latn				
box	Latn				
boy	Latn				
boz	Latn		Arab		
bpa	Latn				
bpb	Latn				
bpc	Latn				
bpd	Latn				
bpe	Latn				
bpg	Latn				
bph	Cyrl				
bpi	Latn				
bpj	Latn				
bpk	Latn				
bpl	Latn				
bpm	Latn				
bpn					
bpo	Latn				
bpp	Latn				
bpq	Latn				
bpr	Latn				
bps	Latn				
bpt	Latn				
bpu	Latn				
bpv	Latn				
bpw	Latn				
bpx	Deva				
bpy	Beng			Latn	
bpz	Latn				
bqa	Latn				
bqb	Latn				
bqc	Latn				
bqd	Latn				
bqf	Arab, Latn				
bqg	Latn				
bqh					
bqi	Arab				
bqj	Latn				
bqk	Latn				
bql	Latn				
bqm	Latn				
bqn	Zxxx				
bqo	Latn				
bqp	Latn				
bqq	Latn				
bqr	Latn				
bqs	Latn				
bqt	Latn				
bqu	Latn				
bqv	Latn				
bqw	Latn				
bqx	Latn				
bqy	Zxxx				
bqz	Latn				
bra	Deva				
brb	Laoo, Latn, Khmr				
brc	Latn				
brd	Deva				
bre	Latn		Ogam		
brf	Latn				
brg	Latn				
brh	Arab, Latn				
bri	Latn				
brj	Latn				
brk	Arab				
brl	Latn				
brm	Latn				
brn	Latn				
bro	Tibt, Latn				
brp	Latn				
brq	Latn				
brr	Latn				
brs	Latn				
brt	Latn				
bru	Laoo, Latn, Thai				
brv	Laoo, Thai				
brw	Knda, Mlym				
brx	Deva, Beng, Latn				
bry	Latn				
brz	Latn				
bsa	Latn				
bsb	Latn				
bsc	Latn				
bse	Latn				
bsf	Latn				
bsg					
bsh	Arab				
bsi	Latn				
bsj	Latn				
bsk	Arab, Latn			Cyrl	
bsl	Latn				
bsm	Latn				
bsn	Latn				
bso	Latn				
bsp	Latn				
bsq	Bass, Latn				
bsr	Latn				
bss	Latn				
bst	Ethi		Latn		
bsu	Latn				
bsv	Arab, Latn				
bsw	Ethi, Latn				
bsx	Latn				
bsy	Latn				
bta	Latn				
btb	Latn				
btc	Latn				
btd	Latn, Batk				
bte	Latn				
btf	Latn				
btg	Latn				
bth	Latn				
bti	Latn				
btj	Latn				
btm	Latn, Batk				
btn	Latn				
bto	Latn	Tglg			
btp	Latn				
btq	Latn				
btr	Latn				
bts	Latn, Batk				
btt	Latn				
btu	Latn				
btv	Deva, Arab				
btw	Latn				
btx	Latn, Batk				
bty	Latn				
btz	Latn, Batk				
bua	Cyrl	Mong, Latn			
bub	Latn				
buc	Latn	Arab			
bud	Latn, Brai				
bue	Latn				
buf	Latn				
bug	Latn, Bugi				
buh	Latn				
bui	Latn				
buj	Latn				
buk	Latn				
bul	Cyrl, Latn, Cyrs, Brai				
bum	Latn				
bun	Latn				
buo	Latn				
bup	Latn				
buq	Latn				
bus	Latn				
but	Latn				
buu	Latn				
buv	Latn				
buw	Latn				
bux	Latn				
buy	Latn				
buz	Latn				
bva	Latn				
bvb	Latn				
bvc	Latn				
bvd	Latn				
bve	Latn				
bvf	Latn				
bvg	Latn				
bvh	Latn				
bvi	Latn				
bvj	Latn				
bvk	Latn				
bvl	Zxxx				
bvm	Latn				
bvn	Latn				
bvo	Latn				
bvp					
bvq	Latn				
bvr	Latn				
bvt	Latn				
bvu	Latn				
bvv	Latn				
bvw	Latn				
bvx	Latn				
bvy	Latn				
bvz	Latn				
bwa	Latn				
bwb	Latn				
bwc	Latn				
bwd	Latn				
bwe	Mymr, Latn				
bwf	Latn				
bwg	Latn				
bwh	Latn				
bwi	Latn				
bwj	Latn				
bwk	Latn				
bwl	Latn				
bwm	Latn				
bwn					
bwo	Ethi, Latn				
bwp	Latn				
bwq	Latn				
bwr	Latn				
bws	Latn				
bwt	Latn				
bwu	Latn				
bww	Latn				
bwx	Latn				
bwy	Latn				
bwz	Latn				
bxa	Latn				
bxb	Latn				
bxc	Latn				
bxd					
bxe					
bxf	Latn				
bxg	Latn				
bxh	Latn				
bxi	Latn				
bxj	Latn				
bxk	Latn				
bxl	Latn				
bxm	Cyrl, Latn, Mong				
bxn	Latn				
bxo	Latn				
bxp	Latn				
bxq	Latn				
bxr	Cyrl				
bxs	Latn				
bxu	Cyrl, Latn, Mong				
bxv	Latn				
bxw	Latn				
bxz	Latn				
bya	Latn				
byb	Latn				
byc	Latn				
byd	Latn				
bye	Latn				
byf	Latn				
byg					
byh	Deva				
byi	Latn				
byj	Latn				
byk	Latn				
byl	Latn				
bym	Latn				
byn	Ethi, Latn				
byo					
byp	Latn				
byq					
byr	Latn				
bys	Latn				
byt					
byv	Latn				
byw	Deva				
byx	Latn				
byz	Latn				
bza	Latn				
bzb	Latn				
bzc	Latn	Brai, Arab			
bzd	Latn				
bze	Latn		Arab		
bzf	Latn				
bzg					
bzh	Latn				
bzi	Thai	Latn			
bzj	Latn				
bzk	Latn				
bzl	Latn				
bzm	Latn				
bzn	Latn				
bzo	Latn				
bzp	Latn				
bzq	Latn				
bzr	Latn				
bzs	Zxxx				
bzt	Latn				
bzu	Latn				
bzv	Latn				
bzw	Latn				
bzx	Latn				
bzy	Latn				
bzz	Latn				
caa	Latn				
cab	Latn				
cac	Latn				
cad	Latn				
cae	Latn				
caf	Cans, Latn				
cag	Latn				
cah	Latn				
caj	Latn				
cak	Latn				
cal	Latn				
cam	Latn				
can	Latn				
cao	Latn				
cap	Latn				
caq	Latn				
car	Latn				
cas	Latn				
cat	Latn	Brai			
cav	Latn				
caw	Latn				
cax	Latn				
cay	Latn				
caz	Latn				
cbb	Latn				
cbc	Latn				
cbd	Latn				
cbg	Latn				
cbi	Latn				
cbj	Latn				
cbk	Latn		Brai		
cbl	Latn				
cbn	Thai				
cbo	Latn				
cbq	Latn				
cbr	Latn				
cbs	Latn				
cbt	Latn				
cbu	Latn				
cbv	Latn				
cbw	Latn				
cby	Latn				
cca	Latn				
ccc	Latn				
ccd	Latn				
cce	Latn				
ccg	Latn				
cch	Latn				
ccj	Latn				
ccl	Latn				
ccm	Latn				
cco	Latn				
ccp	Cakm, Beng, Latn				
ccq					
ccr	Latn				
ccx					
ccy					
cda					
cde	Telu				
cdf	Latn		Beng		
cdg					
cdh	Deva, Takr				
cdi	Gujr				
cdj	Deva, Takr				
cdm	Deva, Latn				
cdn					
cdo	Hant, Hans, Latn				
cdr	Latn				
cds	Zxxx				
cdy					
cdz	Beng				
cea	Latn				
ceb	Latn, Brai	Tglg			
ceg	Latn				
cek	Latn				
cen	Latn				
ces	Latn, Brai				
cet	Latn				
cey	Latn				
cfa	Latn				
cfd	Latn				
cfg	Latn				
cfm	Latn		Beng		
cga	Latn				
cgc	Latn				
cgg	Latn				
cgk	Tibt				
cha	Latn				
chb	Latn				
chc					
chd	Latn				
che	Arab, Cyrl, Latn				
chf	Latn				
chg	Arab				
chh	Latn				
chj	Latn				
chk	Latn				
chl	Latn				
chm	Cyrl, Latn				
chn	Latn, Dupl				
cho	Latn				
chp	Latn, Cans				
chq	Latn				
chr	Cher, Latn				
cht	Latn				
chu	Cyrl, Cyrs, Glag				
chv	Cyrl				
chw	Latn				
chx	Deva				
chy	Latn				
chz	Latn				
cia	Arab, Hang, Latn				
cib	Latn				
cic	Latn				
cid					
cie	Latn				
cih	Deva				
cik					
cim	Latn				
cin	Latn				
cip	Latn				
cir	Latn				
cit					
ciw	Cans, Latn				
ciy	Latn				
cja	Arab, Cham, Latn				
cje	Latn				
cjh	Latn				
cji	Cyrl				
cjk	Latn				
cjm	Arab, Cham, Latn				
cjn	Latn				
cjo	Latn				
cjp	Latn				
cjs	Cyrl		Latn		
cjv	Latn				
cjy	Hant, Hans				
ckb	Arab		Latn		
ckh					
ckl	Latn				
ckm	Glag, Latn				
ckn	Latn				
cko	Latn				
ckq	Latn				
ckr	Latn				
cks	Latn				
ckt	Cyrl				
cku	Latn				
ckv	Latn				
ckx	Latn				
cky	Latn				
ckz	Latn				
cla	Latn				
clc	Latn				
cld					
cle	Latn				
clh	Arab				
cli	Latn				
clj	Latn				
clk	Tibt, Latn				
cll	Latn				
clm	Latn				
clo	Latn				
clt	Latn				
clu	Latn				
clw	Cyrl				
cly	Latn				
cma	Latn				
cme	Latn				
cmg	Zanb, Soyo, Mong				
cmi	Latn				
cml	Latn				
cmm					
cmn	Brai, Bopo, Latn, Hant, Hans, Hani	Arab, Cyrl			
cmo	Latn, Khmr				
cmr	Latn				
cms	Latn				
cmt	Latn				
cna	Tibt				
cnb	Latn				
cnc	Latn				
cng	Latn				
cnh	Latn	Mymr			
cni	Latn				
cnk	Latn				
cnl	Latn				
cnm					
cno					
cnp	Hant, Hans				
cnq	Latn				
cnr	Cyrl, Latn				
cns	Latn				
cnt	Latn				
cnu	Latn				
cnw	Latn				
cnx	Latn				
coa	Latn				
cob	Latn				
coc	Latn				
cod	Latn				
coe	Latn				
cof	Latn				
cog	Thai				
coh	Latn				
coj	Latn				
cok	Latn				
col	Latn				
com	Latn				
con	Latn				
coo	Latn	NAPA			
cop	Copt, Arab, Grek				
coq	Latn				
cor	Latn		Ogam		
cos	Latn				
cot	Latn				
cou	Latn				
cov					
cow					
cox	Latn				
coz	Latn				
cpa	Latn				
cpb	Latn				
cpc	Latn				
cpg	Grek				
cpi	Latn				
cpn	Latn				
cpo	Latn				
cps	Latn				
cpu	Latn				
cpx	Latn	Hani			
cpy	Latn				
cqd	Latn				
cra					
crb	Latn				
crc	Latn				
crd	Latn				
cre	Cans, Latn				
crf	Latn				
crg	Latn				
crh	Arab, Cyrl, Latn				
cri	Latn				
crj	Cans		Latn		
crk	Cans, Latn				
crl	Cans		Latn		
crm	Cans				
crn	Latn				
cro	Latn				
crq	Latn				
crr					
crs	Latn			Cyrl	
crt	Latn				
crv	Latn				
crw	Latn				
crx	Cans, Latn				
cry	Latn				
crz	Latn				
csa	Latn				
csb	Latn				
csc	Zxxx				
csd	Zxxx				
cse	Zxxx				
csf	Zxxx				
csg	Zxxx				
csh	Mymr		Latn		
csi					
csj	Latn				
csk	Latn				
csl	Zxxx				
csm	Latn				
csn	Zxxx				
cso	Latn				
csp	Hant, Hans				
csq	Zxxx				
csr	Zxxx				
css	Latn				
cst	Latn				
csv	Latn				
csw	Latn, Cans				
csx	Zxxx				
csy	Latn				
csz	Latn				
cta	Latn				
ctc	Latn				
ctd	Latn, Pauc				
cte	Latn				
ctg	Arab, Beng, Latn				
cth	Latn				
cti					
ctl	Latn				
ctm	Latn				
ctn	Deva				
cto	Latn				
ctp	Latn				
cts	Latn				
ctt	Taml				
ctu	Latn				
cty	Taml, Mlym				
ctz	Latn				
cua	Latn				
cub	Latn				
cuc	Latn				
cuh	Latn				
cui	Latn				
cuj	Latn				
cuk	Latn				
cul	Latn				
cuo	Latn				
cup	Latn				
cuq					
cur					
cut	Latn				
cuu	Lana				
cuv	Latn				
cuw					
cux	Latn				
cuy	Latn				
cvg	Tibt, Latn				
cvn	Latn				
cwa	Latn				
cwb	Latn				
cwd	Cans, Latn				
cwe	Latn				
cwg	Latn				
cwt	Latn				
cxh	Latn				
cya	Latn				
cyb	Latn				
cym	Latn, Brai		Ogam		
cyo	Latn				
czh	Hant, Hans				
czk	Hebr				
czn	Latn				
czo	Latn				
czt	Latn				
daa	Latn				
dac	Latn				
dad	Latn				
dae	Latn				
daf	Latn				
dag	Latn		Arab		
dah	Latn				
dai	Latn				
daj	Latn				
dak	Latn				
dal	Latn				
dam	Latn				
dan	Latn, Brai		Runr		
dao	Latn				
daq	Deva			Latn	
dar	Cyrl				
das	Latn				
dau	Latn				
dav	Latn				
daw	Latn				
dax	Latn				
daz	Latn				
dba	Latn				
dbb	Latn				
dbd	Latn				
dbe	Latn				
dbf	Latn				
dbg	Latn				
dbi	Latn				
dbj	Arab, Latn				
dbl	Latn				
dbm	Latn				
dbn	Latn				
dbo	Latn				
dbp	Latn				
dbq	Latn				
dbr					
dbt	Latn				
dbu	Latn				
dbv	Latn				
dbw	Latn				
dby	Latn				
dcc	Arab		Deva	Latn	
dcr	Latn				
dda	Latn				
ddd	Latn				
dde	Latn				
ddg	Latn				
ddi	Latn				
ddj	Latn				
ddn	Latn				
ddo	Cyrl				
ddr	Latn				
dds	Latn				
ddw	Latn				
dec	Latn				
ded	Latn				
dee	Latn				
def	Arab				
deg	Latn				
deh	Arab				
dei	Latn				
dek	Latn				
del	Latn				
dem	Latn				
den	Latn, Cans				
dep					
deq	Latn				
der	Beng, Latn				
des	Latn				
deu	Brai, Latn		Latf, Runr, Dupl		
dev	Latn				
dez	Latn				
dga	Latn	Brai			
dgb	Latn				
dgc	Latn				
dgd	Latn				
dge	Latn				
dgg	Latn				
dgh	Latn				
dgi	Latn	Brai			
dgk	Latn				
dgl	Arab		Copt, Latn		
dgn	Latn				
dgo					
dgr	Latn				
dgs	Latn				
dgt	Latn				
dgu					
dgw	Latn				
dgx	Latn				
dgz	Latn				
dhd	Deva			Latn	
dhg	Latn				
dhi	Deva				
dhl	Latn				
dhm	Latn				
dhn	Gujr				
dho	Deva	Gujr			
dhr	Latn				
dhs	Latn				
dhu	Latn				
dhv	Latn				
dhw	Deva				
dhx	Latn				
dia	Latn				
dib	Latn				
dic	Latn				
did	Latn				
dif	Latn				
dig	Latn				
dih	Latn				
dii	Latn				
dij	Latn				
dik	Arab, Latn				
dil	Latn				
dim					
din	Latn		Arab		
dio	Latn				
dip	Latn				
diq	Latn				
dir	Latn				
dis	Latn, Beng				
diu	Latn				
div	Thaa, Diak				
diw	Latn				
dix	Latn				
diy	Latn				
diz	Latn				
dja	Latn				
djb	Latn				
djc	Latn				
djd	Latn				
dje	Latn		Arab, Brai		
djf	Latn				
dji	Latn				
djj	Latn				
djk	Afak, Latn				
djm	Latn				
djn	Latn				
djo	Latn				
djr	Latn				
dju	Latn				
djw	Latn				
dka	Tibt			Latn	
dkg	Latn				
dkk	Latn				
dkr	Latn				
dks	Latn				
dkx	Latn				
dlg	Cyrl				
dlk					
dlm	Latn				
dln	Latn				
dma	Latn				
dmb	Latn				
dmc	Latn				
dmd	Latn				
dme	Latn				
dmf	Medf				
dmg	Latn				
dmk	Arab				
dml	Arab				
dmm	Latn				
dmo	Latn				
dmr	Latn				
dms	Latn				
dmu	Latn				
dmv	Latn				
dmw	Latn				
dmx	Latn				
dmy	Latn				
dna	Latn				
dnd	Latn				
dne	Latn				
dng	Arab, Cyrl	Latn			
dni	Latn				
dnj	Latn				
dnk	Latn				
dnn	Latn				
dno	Latn				
dnr	Latn				
dnt	Latn				
dnu	Mymr				
dnv	Mymr				
dnw	Latn				
dny	Latn				
doa	Latn				
dob	Latn	Brai			
doc	Latn				
doe	Latn				
dof	Latn				
doh	Latn				
doi	Arab, Deva, Takr, Dogr	Mahj		Latn	
dok	Latn				
dol	Latn				
don	Latn				
doo	Latn				
dop	Latn				
doq	Zxxx				
dor	Latn				
dos	Latn				
dot	Latn				
dov	Latn				
dow	Latn				
dox	Ethi				
doy	Latn				
doz					
dpp	Latn				
drb					
drc	Latn				
drd					
dre	Tibt				
drg	Latn				
dri	Latn				
drl	Latn				
drn	Latn				
dro	Latn				
drq	Deva				
drs	Ethi			Latn	
drt	Latn				
dru	Latn				
drw					
dry	Deva				
dsb	Latn				
dse	Zxxx				
dsh	Latn				
dsi	Latn				
dsk	Latn				
dsl	Zxxx				
dsn	Latn				
dso	Orya				
dsq	Latn, Arab				
dsz	Zxxx				
dta	Cyrl, Hans, Latn, Mong				
dtb	Latn				
dtd	Latn				
dth	Latn				
dti	Latn				
dtk	Latn				
dtm	Latn				
dtn					
dto	Latn				
dtp	Latn				
dtr	Latn				
dts	Latn				
dtt	Latn				
dtu	Latn				
dty	Deva				
dua	Latn				
dub	Gujr				
duc	Latn				
due	Latn				
duf	Latn				
dug	Latn				
duh	Deva, Gujr				
dui	Latn				
duk	Latn				
dul	Latn				
dum	Latn				
dun	Latn			Cyrl	
duo	Latn				
dup	Latn				
duq	Latn				
dur	Latn				
dus	Deva				
duu	Latn				
duv	Latn				
duw	Latn				
dux	Latn				
duy	Latn				
duz	Latn				
dva	Latn				
dwa	Latn				
dwk	Orya				
dwr	Ethi, Latn				
dws	Latn				
dwu	Latn				
dww	Latn				
dwy	Latn				
dwz	Deva				
dya	Latn				
dyb	Latn				
dyd	Latn				
dyg	Latn				
dyi	Latn				
dym	Latn				
dyn	Latn				
dyo	Latn		Arab		
dyr	Latn				
dyu	Arab, Latn, Nkoo				
dyy	Latn				
dza	Latn				
dzd	Latn				
dze	Latn				
dzg	Latn				
dzl	Tibt				
dzn	Latn				
dzo	Tibt	Brai			
eaa	Latn				
ebc	Latn				
ebg	Latn				
ebk	Latn				
ebo	Latn				
ebr	Latn				
ebu	Latn				
ecr	Grek				
ecs	Zxxx				
ecy	Cprt				
eee					
efa	Latn				
efe	Latn				
efi	Latn	Nsibidi			
ega	Latn				
egl	Latn				
egm	Latn				
ego	Latn				
egy	Egyp				
ehs	Zxxx				
ehu	Latn				
eip	Latn				
eit	Latn				
eiv	Latn				
eja	Latn				
eka	Latn				
ekc	Latn				
eke	Latn				
ekg	Latn				
eki	Latn				
ekk	Latn	Brai			
ekl	Latn				
ekm	Latn				
eko	Latn		Arab		
ekp	Latn				
ekr	Latn				
eky	Kali, Thai				
ele	Latn				
elh					
eli					
elk	Latn				
ell	Grek, Brai		Cyrl	Latn	
elm	Latn				
elo	Latn				
elu	Latn				
elx	Pelm				
ema	Latn				
emb	Latn				
eme	Latn				
emg	Deva				
emi	Latn				
emk	Latn, Nkoo				
eml	Latn				
emm	Latn				
emn	Latn				
emp	Latn				
emq					
ems	Cyrl, Latn				
emu	Deva				
emw	Latn				
emx	Latn				
emy	Maya				
emz	Latn				
ena	Latn				
enb	Latn				
enc	Latn				
end	Latn	Bugi			
enf	Cyrl				
eng	Brai, Shaw, Latn, Dsrt, Runr		Dupl		
enh	Cyrl				
enl	Latn				
enm	Latn, Runr				
enn	Latn				
eno	Latn				
enq	Latn				
enr	Latn				
enu					
env	Latn				
enw	Latn				
enx	Latn				
eot	Latn				
epi	Latn				
epo	Latn	Brai			
era	Taml			Latn	
erg	Latn				
erh	Latn				
eri	Latn				
erk	Latn				
ero					
err	Latn				
ers	Latn				
ert	Latn				
erw	Latn				
ese	Latn				
esg	Deva, Gonm, Telu	Orya, Gong			
esh	Arab				
esi	Latn	Brai			
esk	Latn	Brai			
esl	Zxxx				
esm	Latn				
esn	Zxxx				
eso	Zxxx				
esq					
ess	Cyrl, Latn				
est	Latn, Brai				
esu	Latn	Yugtun			
esy	Zzzz, Latn				
etb	Latn				
etc					
eth	Zxxx				
etn	Latn				
eto	Latn				
etr	Latn				
ets	Latn				
ett	Ital, Latn				
etu	Latn	Nsibidi			
etx	Latn				
etz	Latn				
eud	Latn				
eus	Latn	Brai			
eve	Cyrl, Cyrs			Latn	
evh	Latn				
evn	Cyrl, Latn, Mong				
ewe	Latn, Brai				
ewo	Latn				
ext	Latn				
eya	Latn				
eyo	Latn				
eza	Latn				
eze	Latn				
faa	Latn				
fab	Latn				
fad	Latn				
faf	Latn				
fag	Latn				
fah	Latn				
fai	Latn				
faj	Latn				
fak	Latn				
fal	Latn				
fam	Latn				
fan	Latn				
fao	Latn	Brai	Runr		
fap	Latn				
far	Latn				
fas	Arab	Xpeo, Phli, Prti, Phlp, Phlv, Brai		Latn
fat	Latn				
fau	Latn				
fax	Latn				
fay	Arab				
faz	Arab				
fbl	Latn				
fcs	Zxxx				
fer	Latn				
ffi	Latn				
ffm	Arab, Latn				
fgr	Latn				
fia	Arab, Copt, Latn				
fie	Latn				
fif	Latn				
fij	Latn				
fil	Latn, Tglg				
fin	Latn, Brai				
fip	Latn				
fir	Latn				
fit	Latn				
fiw	Latn				
fkk	Latn				
fkv	Latn				
fla	Latn				
flh	Latn				
fli	Latn				
fll	Latn				
flm					
fln	Latn				
flr	Latn				
fly	Latn				
fmp	Latn				
fmu	Deva				
fnb	Latn				
fng	Latn				
fni	Latn				
fod	Latn				
foi	Latn				
fom	Latn				
fon	Latn	Nkoo			
for	Latn				
fos	Latn				
fpe	Latn				
fqs	Latn				
fra	Latn, Dupl, Brai				
frc	Latn				
frd	Latn				
fri					
frk	Latn				
frm	Latn				
fro	Latn				
frp	Latn				
frq	Latn				
frr	Latn				
frs	Latn				
frt	Latn				
fry	Latn				
fse	Zxxx				
fsl	Zxxx				
fss	Zxxx				
fub	Arab, Latn				
fuc					
fud	Latn				
fue	Latn				
fuf	Arab, Adlm, Latn				
fuh	Arab, Latn				
fui	Latn				
fuj					
ful	Arab, Latn, Adlm				
fum	Latn				
fun	Latn				
fuq	Latn				
fur	Latn				
fut	Latn				
fuu	Latn				
fuv	Arab, Latn				
fuy	Latn				
fvr	Latn				
fwa	Latn				
fwe	Latn				
gaa	Latn	Brai	Arab		
gab	Latn				
gac	Deva, Latn				
gad	Latn				
gae	Latn				
gaf	Latn				
gag	Cyrl, Latn		Grek		
gah	Latn				
gai	Latn				
gaj	Latn				
gak	Latn				
gal	Latn				
gam	Latn				
gan	Hant, Hans, Latn				
gao	Latn				
gap	Latn				
gaq	Orya				
gar	Latn				
gas	Gujr	Deva			
gat	Latn				
gau	Telu				
gaw	Latn				
gax	Ethi, Latn				
gay	Latn				
gaz	Latn				
gba	Arab, Latn				
gbb	Latn				
gbd	Latn				
gbe	Latn				
gbf	Latn				
gbg	Latn				
gbh	Latn				
gbi	Latn				
gbj	Orya				
gbk	Deva, Takr				
gbl	Deva, Gujr				
gbm	Deva			Latn	
gbn	Latn				
gbo	Latn				
gbp	Latn				
gbq	Latn				
gbr	Latn				
gbs	Latn				
gbu	Latn				
gbv	Latn				
gbw	Latn				
gbx	Latn				
gby	Latn				
gbz	Arab				
gcc	Latn				
gcd	Latn				
gce					
gcf	Latn				
gcl	Latn				
gcn	Latn				
gcr	Latn				
gct	Latn				
gda					
gdb	Telu, Orya				
gdc	Latn				
gdd	Latn				
gde	Latn				
gdf	Latn				
gdg	Latn				
gdh	Latn				
gdi	Latn				
gdj	Latn				
gdk	Latn				
gdl	Ethi, Latn				
gdm	Latn				
gdn	Latn				
gdo	Cyrl				
gdq	Arab		Latn		
gdr	Latn				
gds	Zxxx				
gdt	Latn				
gdu	Latn				
gdx	Deva			Arab, Latn	
gea	Latn				
geb	Latn				
gec	Latn				
ged	Latn				
gef	Latn				
geg	Latn				
geh	Latn				
gei	Latn				
gej	Latn				
gek	Latn				
gel	Latn				
geq	Latn				
ges	Latn				
gev	Latn				
gew	Latn				
gex	Latn				
gey	Latn				
gez	Ethi				
gfk	Latn				
gft					
gga	Latn				
ggb	Latn				
ggd	Latn				
gge	Latn				
ggg	Arab				
ggk	Latn				
ggl	Latn				
ggn					
ggo					
ggr					
ggt	Latn				
ggu	Latn				
ggw	Latn				
gha	Arab, Tfng, Latn				
ghc	Latn				
ghe	Deva				
ghh					
ghk	Latn				
ghl					
ghn	Latn				
gho	Latn				
ghr	Arab				
ghs	Latn				
ght	Tibt				
gia	Latn				
gib	Latn				
gic	Latn				
gid	Latn				
gie	Latn				
gig	Arab				
gih	Latn				
gii					
gil	Latn				
gim	Latn				
gin	Cyrl				
gip	Latn				
giq	Latn				
gir	Latn				
gis	Latn				
git	Latn				
giu					
giw					
gix	Latn				
giy	Latn				
giz	Latn				
gjk	Arab, Gujr				
gjm	Latn				
gjn	Latn		Arab		
gjr	Latn				
gju	Deva, Arab	Takr		Latn	
gka	Latn				
gkd	Latn				
gke	Latn				
gkn	Latn				
gko	Latn				
gkp	Latn	Kpel			
gku	Latn				
gla	Ogam, Latn	Latg			
glb	Latn				
glc	Latn				
gld	Cyrl				
gle	Latg, Ogam, Latn	Brai			
glg	Latn	Brai			
glh	Arab				
glj	Latn				
glk	Arab		Latn		
gll	Latn				
glo	Latn				
glr	Latn				
glu	Latn				
glv	Latn		Ogam		
glw	Latn				
gly					
gma	Latn				
gmb	Latn				
gmd	Latn				
gmg	Latn				
gmh	Latn				
gml	Latf				
gmm	Latn				
gmn	Latn				
gmo					
gmr	Latn				
gmu	Latn				
gmv	Ethi, Latn				
gmx	Latn				
gmy	Linb				
gmz	Latn				
gna	Latn				
gnb	Latn				
gnc	Latn				
gnd	Latn				
gne	Latn				
gng	Latn				
gnh	Latn				
gni	Latn				
gnj	Latn				
gnk	Latn				
gnl	Latn				
gnm	Latn				
gnn	Latn				
gno	Deva, Gonm, Telu	Gong, Orya		Latn	
gnq	Latn				
gnr	Latn				
gnt	Latn				
gnu	Latn				
gnw	Latn				
gnz	Latn				
goa	Latn				
gob	Latn				
goc	Latn				
god	Latn	Bété			
goe	Tibt				
gof	Ethi, Latn				
gog	Latn				
goh	Latn				
goi	Latn				
goj	Deva				
gok	Deva				
gol	Latn				
gom	Deva, Knda, Latn	Mlym, Arab, Modi, Goykanadi, Nāgarī, Brah			
gon	Deva, Gonm, Telu, Gong	Orya			
goo	Latn				
gop	Latn				
goq	Latn				
gor	Latn				
gos	Latn				
got	Goth, Latn				
gou	Latn				
gov	Latn				
gow	Latn				
gox	Latn				
goy	Latn				
goz					
gpa	Latn				
gpe	Latn				
gpn	Latn				
gqa	Latn				
gqi					
gqn	Latn				
gqr	Latn				
gqu					
gra	Deva, Gujr				
grb	Latn				
grc	Linb, Grek, Cprt				
grd	Latn				
grg	Latn				
grh	Latn				
gri	Latn				
grj	Latn				
grm	Latn				
grn	Latn				
gro					
grq	Latn				
grr	Arab, Tfng				
grs	Latn				
grt	Beng, Latn	A-Chik Tokbirim	Brai		
gru	Ethi		Latn		
grv	Latn				
grw	Latn				
grx	Latn				
gry	Latn				
grz	Latn				
gse	Zxxx				
gsg	Zxxx				
gsl	Latn				
gsm	Zxxx				
gsn	Latn				
gso	Latn				
gsp	Latn				
gss	Zxxx				
gsw	Latn				
gta	Latn				
gtu	Latn				
gua	Latn				
gub	Latn				
guc	Latn				
gud	Latn				
gue	Latn				
guf	Latn				
gug	Latn				
guh	Latn				
gui	Latn				
guj	Gujr, Brai		Khoj	Latn	
guk	Latn, Ethi				
gul	Latn				
gum	Latn				
gun	Latn				
guo	Latn				
gup	Latn				
guq	Latn				
gur	Latn				
gus	Zxxx				
gut	Latn				
guu	Latn				
guw	Latn				
gux	Latn				
guz	Latn	Arab			
gva	Latn				
gvc	Latn				
gve	Latn				
gvf	Latn				
gvj	Latn				
gvl	Latn				
gvm	Latn				
gvn	Latn				
gvo	Latn				
gvp	Latn				
gvr	Deva	Khema, Tibt	Latn		
gvs	Latn				
gvy	Latn				
gwa	Latn				
gwb	Latn				
gwc	Arab				
gwd	Latn				
gwe	Latn				
gwf	Arab				
gwg	Latn				
gwi	Latn				
gwj	Latn				
gwm	Latn				
gwn	Latn				
gwr	Latn				
gwt	Arab				
gwu	Latn				
gww	Latn				
gwx	Latn				
gxx	Latn				
gya	Latn				
gyb	Latn				
gyd	Latn				
gye	Latn				
gyf	Latn				
gyg	Latn				
gyi	Latn				
gyl	Ethi, Latn				
gym	Latn				
gyn	Latn				
gyo	Deva				
gyr	Latn				
gyy	Latn				
gyz	Latn				
gza	Latn				
gzi	Arab				
gzn	Latn				
haa	Latn				
hab	Zxxx				
hac	Arab				
had	Latn				
hae	Latn				
haf	Zxxx				
hag	Latn				
hah	Latn				
hai	Latn				
haj	Beng, Latn				
hak	Hant, Hans, Latn, Hani				
hal	Latn				
ham	Latn				
han	Latn				
hao	Latn				
hap	Latn				
haq	Latn				
har	Ethi		Arab, Latn		
has	Latn				
hat	Latn				
hau	Arab, Latn, Brai				
hav	Latn				
haw	Latn	Brai			
hax	Latn				
hay	Latn				
haz	Arab	Latn			
hba	Latn				
hbb	Latn				
hbn	Latn				
hbo	Hebr				
hbs	Cyrl, Latn				
hbu	Latn				
hca					
hch	Latn				
hdn	Latn				
hds	Zxxx				
hdy	Ethi, Latn				
hea	Latn				
heb	Hebr, Brai			Latn	
hed	Latn				
heg	Latn				
heh	Latn				
hei	Latn				
hem	Latn				
her	Latn	Brai			
hgm	Latn				
hgw	Latn				
hhi	Latn				
hhr	Latn				
hhy	Latn				
hia	Latn				
hib	Latn				
hid	Latn				
hif	Latn, Deva	Kthi, Arab			
hig	Latn				
hih	Latn				
hii	Deva, Takr				
hij	Latn				
hik	Latn				
hil	Latn, Brai	Tglg			
hin	Brai, Deva, Latn, Mahj	Landa, Kthi	Newa		
hio	Latn				
hir	Latn				
hit	Xsux				
hiw	Latn				
hix	Latn				
hji	Latn				
hka	Latn				
hke	Latn				
hkh	Deva, Arab, Latn				
hkk	Latn				
hkn					
hks	Zxxx				
hla	Latn				
hlb	Deva, Orya			Latn	
hld	Latn				
hle					
hlt	Latn				
hlu	Hluw				
hma	Latn				
hmb	Latn				
hmc					
hmd	Plrd, Hmng, Latn				
hme					
hmf	Latn				
hmg					
hmh					
hmi					
hmj	Bopo				
hmk					
hml					
hmm	Latn				
hmn	Latn, Hmng	Plrd, Hmnp, Laoo, Thai	Bopo		
hmo	Latn		Brai		
hmp	Latn				
hmq	Latn		Bopo		
hmr	Latn				
hms	Latn				
hmt	Latn				
hmu	Latn				
hmv	Latn				
hmw	Latn				
hmy	Latn				
hmz	Latn, Plrd	Hmng, Hmnp			
hna	Latn				
hnd	Arab			Latn	
hne	Deva			Latn	
hng	Latn				
hnh	Latn				
hni	Latn				
hnj	Thai, Hmng, Hmnp, Latn, Plrd, Laoo				
hnn	Hano, Latn				
hno	Arab			Latn	
hns	Latn	Deva, Kthi, Arab			
hnu					
hoa	Latn				
hob	Latn				
hoc	Deva, Latn, Orya, Telu, Wara				
hod	Latn				
hoe	Latn				
hoh	Arab				
hoi	Latn				
hoj	Deva			Latn	
hol	Latn				
hom	Latn				
hoo	Latn				
hop	Latn				
hor	Latn				
hos	Zxxx				
hot	Latn				
hov	Latn				
how	Hani, Latn				
hoy	Deva				
hoz					
hpo	Mymr				
hps	Zxxx				
hra	Latn				
hrc	Latn				
hre	Latn				
hrk	Latn				
hrm	Latn, Hmng				
hro	Latn				
hrp	Latn				
hrt	Syrc				
hru	Latn				
hrv	Latn, Brai			Glag	
hrw	Latn				
hrx	Latn				
hrz	Arab				
hsb	Latn				
hsh	Zxxx				
hsl	Zxxx				
hsn	Hant, Hans, Latn		Nshu		
hss	Arab				
hti	Latn				
hto	Latn				
hts	Latn				
htu	Latn				
htx	Xsux				
hub	Latn				
huc	Latn				
hud	Latn				
hue	Latn				
huf	Latn				
hug	Latn				
huh	Latn				
hui	Latn	Brai			
huj					
huk	Latn				
hul	Latn				
hum	Latn				
hun	Brai, Latn, Hung				
huo					
hup	Latn				
huq					
hur	Latn	NAPA			
hus	Latn				
hut	Deva, Tibt				
huu	Latn				
huv	Latn				
huw	Latn				
hux	Latn				
huy	Hebr				
huz	Cyrl				
hvc	Latn				
hve	Latn				
hvk	Latn				
hvn	Latn				
hvv	Latn				
hwa	Latn				
hwc	Latn				
hwo	Latn				
hya	Latn				
hye	Brai, Armn			Latn	
hyw	Armn				
iai	Latn				
ian	Latn				
iap	Latn				
iar	Latn				
iba	Latn	Dunging			
ibb	Latn	Nsibidi			
ibd	Latn				
ibe	Latn				
ibg	Latn				
ibh	Latn				
ibl	Latn				
ibm	Latn				
ibn	Latn				
ibo	Latn	Nwagu Aneke, Nsibidi, Ndebe, Brai			
ibr	Latn				
ibu	Latn				
iby	Latn				
ica	Latn				
ich	Latn				
icl	Zxxx				
icr	Latn				
ida	Latn				
idb	Latn				
idc	Latn				
idd	Latn				
ide	Latn				
idi	Latn				
ido	Latn				
idr	Latn				
ids	Latn				
idt	Latn				
idu	Latn				
ifa	Latn				
ifb	Latn				
ife	Latn				
iff	Latn				
ifk	Latn				
ifm	Latn				
ifu	Latn				
ify	Latn				
igb	Latn				
ige	Latn				
igg	Latn				
igl	Latn				
igm	Latn				
ign	Latn				
igo	Latn				
igs	Latn, Grek				
igw	Latn				
ihb	Latn				
ihi	Latn				
ihp	Latn				
ihw	Latn				
iii	Yiii, Latn				
iin	Latn				
ijc	Latn				
ije	Latn				
ijj	Latn				
ijn	Latn				
ijs	Latn				
ike	Cans, Latn	Brai			
ikh	Latn				
iki	Latn				
ikk	Latn				
ikl	Latn				
iko	Latn				
ikp	Latn				
ikr	Latn				
iks	Zxxx				
ikt	Latn, Cans				
iku	Cans, Latn	Brai			
ikv	Latn				
ikw	Latn				
ikx	Latn				
ikz	Latn				
ila	Latn				
ilb	Latn				
ile	Latn				
ilg	Latn				
ili	Latn		Arab, Cyrl		
ilk	Latn				
ill					
ilm	Latn	Arab			
ilo	Tglg, Latn, Brai				
ilp	Latn	Arab			
ils	Zxxx				
ilu	Latn				
ilv	Latn				
ima					
imi	Latn				
iml	Latn				
imn	Latn				
imo	Latn				
imr	Latn				
ims	Latn				
imt	Latn				
imy	Lyci				
ina	Latn				
inb	Latn				
ind	Latn, Brai		Arab		
ing	Latn				
inh	Arab, Cyrl, Latn				
inj	Latn				
inl	Zxxx				
inm					
inn	Latn				
ino	Latn				
inp	Latn				
ins	Zxxx				
int	Mymr				
inz					
ior	Ethi				
iou	Latn				
iow	Latn				
ipi	Latn				
ipk	Latn	Brai			
ipo	Latn				
iqu	Latn				
iqw	Latn				
ire	Latn				
irh	Latn				
iri	Latn				
irk	Latn				
irn	Latn				
irr					
iru	Taml		Mlym		
irx	Latn				
iry	Latn				
isa	Latn				
isc	Latn				
isd	Latn				
ise	Zxxx				
isg	Zxxx				
ish	Latn				
isi	Latn				
isk	Arab, Cyrl				
isl	Latn	Brai	Runr		
ism	Latn				
isn	Latn				
iso	Latn				
isr	Zxxx				
ist	Latn				
isu	Latn				
ita	Latn, Brai				
itb	Latn				
itd	Latn				
ite	Latn				
iti	Latn				
itk	Hebr				
itl	Cyrl				
itm	Latn				
ito	Latn				
itr	Latn				
its	Latn				
itt	Latn				
itv	Latn				
itw	Latn				
itx	Latn				
ity	Latn				
itz	Latn				
ium	Latn		Hani, Laoo, Thai		
ivb	Latn				
ivv	Latn				
iwk	Latn				
iwm	Latn				
iwo	Latn				
iws	Latn				
ixc	Latn				
ixi					
ixj					
ixl	Latn				
iya	Latn				
iyo	Latn				
iyx	Latn				
izh	Latn				
izm	Latn				
izr	Latn				
izz	Latn				
jaa	Latn				
jab	Latn				
jac	Latn				
jad	Arab				
jae	Latn				
jaf	Latn				
jah	Latn				
jaj	Latn				
jak	Latn				
jal	Latn				
jam	Latn				
jan	Latn				
jao	Latn				
jaq	Latn				
jas	Latn				
jat	Arab				
jau	Latn				
jav	Arab, Latn, Java				
jax	Latn				
jay	Latn				
jaz	Latn				
jbe	Hebr				
jbi	Latn				
jbj	Latn				
jbk	Latn				
jbm	Latn				
jbn	Arab				
jbo	Latn				
jbr	Latn				
jbt	Latn				
jbu	Latn				
jbw	Latn				
jcs	Zxxx				
jct	Cyrl, Latn	Hebr			
jda	Tibt				
jdg	Arab				
jdt	Cyrl, Hebr, Latn				
jeb	Latn				
jee	Deva				
jeh	Laoo, Latn				
jei	Latn				
jek	Latn				
jel	Latn				
jen	Latn				
jer	Latn				
jet	Latn				
jeu	Latn				
jgb	Latn				
jge	Hebr, Geor				
jgk	Latn				
jgo	Latn				
jhi	Latn				
jhs	Zxxx				
jia	Latn				
jib	Latn				
jic	Latn				
jid	Latn				
jie	Latn				
jig	Latn				
jih					
jii					
jil	Latn				
jim	Latn				
jio					
jiq					
jit	Latn				
jiu	Latn				
jiv	Latn				
jiy	Latn				
jje	Hang, Kore				
jjr	Latn				
jka	Latn				
jkm	Mymr, Latn, Brai				
jko	Latn				
jkp					
jkr					
jks	Zxxx				
jku	Latn				
jle	Latn				
jls	Zxxx				
jma	Latn				
jmb	Latn				
jmc	Latn				
jmd	Latn				
jmi	Latn				
jml	Deva				
jmn	Latn				
jmr	Latn				
jms	Latn				
jmw	Latn				
jmx	Latn				
jna	Takr				
jnd	Arab				
jng	Latn				
jni	Latn				
jnj	Ethi, Latn				
jnl	Deva				
jns	Deva	Sirmauri	Takr, Latn		
job	Latn				
jod	Latn	Nkoo			
jog	Arab				
jor	Latn				
jos	Zxxx				
jow	Latn				
jpa	Hebr				
jpn	Jpan, Latn, Brai, Hani, Hira, Kana				
jpr	Hebr				
jqr	Latn				
jra	Latn, Khmr				
jrb	Hebr		Arab		
jrr	Latn				
jrt	Latn				
jru	Latn				
jsl	Zxxx				
jua	Latn				
jub	Latn				
juc	Jurc				
jud	Latn				
juh	Latn				
jui	Latn				
juk	Latn				
jul	Deva				
jum	Latn				
jun	Orya				
juo	Latn				
jup	Latn				
jur	Latn				
jus	Zxxx				
jut	Latn				
juu	Latn				
juw	Latn				
juy	Orya				
jvd	Latn				
jvn	Latn	Java, Arab			
jwi	Latn				
jya	Tibt				
jye	Hebr				
jyy	Latn				
kaa	Arab, Cyrl, Latn				
kab	Arab, Tfng, Latn				
kac	Latn				
kad	Latn				
kae					
kaf					
kag	Latn				
kah	Latn				
kai	Latn	Arab			
kaj	Latn				
kak	Latn				
kal	Latn	Brai			
kam	Latn				
kan	Knda, Brai		Nand	Latn	
kao	Latn				
kap	Cyrl				
kaq	Latn				
kas	Arab, Deva, Latn, Shrd				
kat	Geok, Geor, Brai			Latn	
kau	Latn, Arab				
kav	Latn				
kaw	Kawi, Bali	Java			
kax	Latn				
kay	Latn				
kaz	Arab, Cyrl, Latn, Brai				
kba	Latn				
kbb	Latn				
kbc	Latn				
kbd	Cyrl	Latn, Arab			
kbe	Latn				
kbg	Tibt				
kbh	Latn				
kbi	Latn				
kbj	Latn				
kbk	Latn				
kbl	Latn				
kbm	Latn				
kbn	Latn				
kbo	Latn				
kbp	Latn, Brai				
kbq	Latn				
kbr	Latn		Ethi		
kbs	Latn				
kbt	Latn				
kbu	Arab				
kbv	Latn				
kbw	Latn				
kbx	Latn				
kby	Arab, Latn				
kbz	Latn				
kca	Cyrl				
kcb	Latn				
kcc	Latn				
kcd	Latn				
kce	Latn				
kcf	Latn				
kcg	Latn				
kch	Latn				
kci	Latn				
kcj	Latn				
kck	Latn				
kcl	Latn				
kcm	Latn				
kcn	Latn				
kco	Latn				
kcp	Latn				
kcq	Latn				
kcr					
kcs	Latn				
kct	Latn				
kcu	Latn				
kcv	Latn				
kcw	Latn				
kcx					
kcy	Arab				
kcz	Latn				
kda	Latn				
kdc	Latn				
kdd	Latn				
kde	Latn				
kdf	Latn				
kdg	Latn				
kdh	Arab, Latn, Brai				
kdi	Latn				
kdj	Latn				
kdk	Latn				
kdl	Latn				
kdm	Latn				
kdn	Latn				
kdp	Latn				
kdq	Beng				
kdr	Cyrl, Latn	Hebr			
kds					
kdt	Khmr, Laoo, Thai				
kdu					
kdw	Latn				
kdx	Latn				
kdy	Latn				
kdz	Latn				
kea	Latn				
keb	Latn				
kec	Latn				
ked	Latn				
kee	Latn				
kef	Latn				
keg	Latn				
keh	Latn				
kei	Latn				
kej					
kek	Latn				
kel	Latn				
kem	Latn				
ken	Latn				
keo	Latn				
kep					
keq					
ker	Latn				
kes	Latn				
ket	Cyrl				
keu	Latn				
kev	Taml, Mlym				
kew	Latn				
kex	Deva, Gujr				
key	Telu				
kez	Latn				
kfa	Knda	Mlym, Kodava			
kfb	Deva	Telu			
kfc	Telu				
kfd	Knda				
kfe	Taml				
kff	Deva, Telu, Latn, Orya				
kfg	Knda, Mlym				
kfh	Mlym				
kfi	Knda, Taml				
kfj					
kfk	Deva, Takr				
kfl	Latn				
kfm	Arab				
kfn	Latn				
kfo	Latn	Nkoo			
kfp	Deva				
kfq	Deva			Latn	
kfr	Deva, Gujr, Arab, Khoj	Sind			
kfs	Deva, Takr				
kft	Deva				
kfu	Deva				
kfv	Latn				
kfw	Latn				
kfx	Deva, Takr				
kfy	Deva			Latn	
kfz	Latn				
kga	Latn				
kgb	Latn				
kge	Latn	Lampung, Rjng			
kgf	Latn				
kgg					
kgi	Zxxx				
kgj	Deva				
kgk	Latn				
kgl	Latn				
kgm	Latn				
kgn					
kgo	Latn				
kgp	Latn				
kgq	Latn				
kgr	Latn				
kgs	Latn				
kgt	Latn				
kgu	Latn				
kgv	Latn				
kgw	Latn				
kgx	Latn				
kgy	Deva				
kha	Beng, Latn				
khb	Talu, Lana	Thai			
khc	Latn				
khd	Latn				
khe	Latn				
khf	Thai				
khg	Tibt				
khh	Latn				
khj	Latn				
khk	Cyrl, Phag				
khl	Latn				
khm	Khmr	Brai		Latn	
khn	Deva				
kho	Khar, Brah				
khp	Latn				
khq	Latn				
khr	Latn, Deva	Orya			
khs	Latn				
kht	Mymr				
khu	Latn				
khv	Cyrl				
khw	Arab				
khx	Latn				
khy	Latn				
khz	Latn				
kia	Latn				
kib	Latn				
kic	Latn				
kid	Latn				
kie	Latn				
kif	Deva				
kig	Latn				
kih	Latn				
kii					
kij	Latn				
kik	Latn				
kil	Latn				
kim	Cyrl				
kin	Latn		Brai		
kio	Latn				
kip	Deva				
kiq	Latn				
kir	Arab, Cyrl, Latn	Brai			
kis	Latn				
kit	Latn				
kiu	Latn				
kiv	Latn				
kiw	Latn				
kix	Latn				
kiy	Latn				
kiz	Latn				
kja	Latn				
kjb	Latn				
kjc	Latn				
kjd	Latn				
kje	Latn				
kjf					
kjg	Laoo, Latn, Thai				
kjh	Cyrl				
kji	Latn				
kjj	Cyrl, Latn				
kjk	Latn				
kjl	Deva				
kjm	Latn				
kjn	Latn				
kjo	Deva				
kjp	Leke, Mymr, Thai				
kjq	Latn				
kjr	Latn				
kjs	Latn				
kjt	Thai				
kju	Latn				
kjv	Latn				
kjx	Latn				
kjy	Latn				
kjz	Tibt				
kka	Latn				
kkb	Latn				
kkc	Latn				
kkd	Latn				
kke	Arab, Latn				
kkf	Tibt				
kkg	Latn				
kkh	Lana, Thai				
kki	Latn				
kkj	Latn				
kkk	Latn				
kkl	Latn				
kkm	Latn				
kkn					
kko	Latn				
kkp	Latn				
kkq	Latn				
kkr	Latn				
kks	Latn				
kkt	Deva				
kku	Latn				
kkv	Latn	Java, Bugi, Maka, Arab			
kkw	Latn				
kkx	Latn				
kky	Latn				
kkz	Latn				
kla	Latn				
klb	Latn				
klc	Latn				
kld	Latn				
kle	Deva				
klf	Latn				
klg	Latn				
klh	Latn				
kli	Latn				
klj	Arab				
klk	Latn				
kll	Latn				
klm	Latn				
kln	Latn				
klo	Latn				
klp	Latn				
klq	Latn				
klr	Deva				
kls	Arab, Latn				
klt	Latn				
klu	Latn				
klv	Latn				
klw	Latn				
klx	Latn				
kly	Latn				
klz	Latn				
kma	Latn				
kmb	Latn				
kmc	Latn		Hani		
kmd	Latn				
kme	Latn				
kmf	Latn				
kmg	Latn				
kmh	Latn				
kmi	Latn				
kmj	Deva				
kmk	Latn				
kml	Latn				
kmm	Latn				
kmn	Latn				
kmo	Latn				
kmp	Latn				
kmq	Latn				
kmr	Latn		Cyrl, Yezi		
kms	Latn				
kmt	Latn				
kmu	Latn				
kmv	Latn				
kmw	Latn				
kmx	Latn				
kmy	Latn				
kmz	Arab			Latn	
kna	Latn				
knb	Latn				
knc	Arab, Latn				
knd	Latn				
kne	Latn				
knf	Latn				
kng	Latn				
kni	Latn				
knj	Latn				
knk	Latn		Arab		
knl	Latn				
knm	Latn				
knn	Knda, Latn				
kno	Latn				
knp	Latn				
knq	Latn				
knr	Latn				
kns	Latn, Thai				
knt	Latn				
knu	Latn				
knv	Latn				
knw	Latn				
knx	Latn				
kny	Latn				
knz	Latn				
koa	Latn				
koc	Latn				
kod	Latn				
koe	Latn				
kof	Latn				
kog	Latn				
koh	Latn				
koi	Cyrl		Perm, Latn		
kok	Deva, Knda, Latn	Mlym, Arab, Modi, Goykanadi, Nāgarī, Brah			
kol	Latn				
kom	Cyrl, Perm, Cyrs		Latn		
kon	Latn	Mandombe			
koo	Latn				
kop	Latn				
koq	Latn				
kor	Kore, Hang, Hani		Brai, Latn		
kos	Latn				
kot	Latn				
kou	Latn				
kov	Latn				
kow	Latn				
koy	Latn				
koz	Latn				
kpa	Latn				
kpb					
kpc	Latn				
kpd	Latn				
kpe	Latn, Kpel				
kpf	Latn				
kpg	Latn				
kph	Latn				
kpi	Latn				
kpj	Latn				
kpk	Latn				
kpl	Latn				
kpm	Latn				
kpn	Latn				
kpo	Latn				
kpp					
kpq	Latn				
kpr	Latn				
kps	Latn				
kpt	Cyrl				
kpu	Latn				
kpv	Cyrs, Cyrl				
kpw	Latn				
kpx	Latn				
kpy	Cyrl				
kpz	Latn				
kqa	Latn				
kqb	Latn				
kqc	Latn				
kqd	Syrc				
kqe	Latn				
kqf	Latn				
kqg	Latn				
kqh	Latn				
kqi	Latn				
kqj	Latn				
kqk	Latn				
kql	Latn				
kqm	Latn				
kqn	Latn	Brai			
kqo	Latn				
kqp	Latn				
kqq	Latn				
kqr	Latn				
kqs	Latn				
kqt	Latn				
kqu	Latn				
kqv	Latn				
kqw	Latn				
kqx	Latn				
kqy	Ethi, Latn				
kqz	Latn				
kra	Deva				
krb	Latn				
krc	Cyrl	Latn			
krd	Latn				
kre	Latn				
krf	Latn				
krh	Latn				
kri	Latn				
krj	Latn				
krk	Cyrl				
krl	Latn		Cyrl		
krn	Latn				
krp	Latn				
krq					
krr	Khmr				
krs	Latn				
krt	Latn				
kru	Deva	Kurukh Banna, Tolong Siki		Latn	
krv	Khmr				
krw	Latn				
krx	Latn				
kry	Latn				
krz	Latn				
ksa	Latn				
ksb	Latn				
ksc	Latn				
ksd	Latn	Brai			
kse	Latn				
ksf	Latn				
ksg	Latn				
ksh	Latn				
ksi	Latn				
ksj	Latn				
ksk	Latn				
ksl	Latn				
ksm	Latn				
ksn	Latn				
kso	Latn				
ksp	Latn				
ksq	Latn				
ksr	Latn				
kss	Latn				
kst	Latn				
ksu	Mymr				
ksv	Latn				
ksw	Latn, Mymr	Brai			Thai
ksx	Latn				
ksy					
ksz	Deva				
kta	Latn				
ktb	Ethi, Latn				
ktc	Latn				
ktd	Latn				
kte	Deva, Tibt				
ktf	Latn				
ktg	Latn				
kth	Latn				
kti	Latn				
ktj	Latn				
ktk	Latn				
ktl	Arab				
ktm	Latn				
ktn	Latn				
kto	Latn				
ktp			Plrd	Latn	
ktq	Latn				
kts	Latn				
ktt	Latn				
ktu	Latn				
ktv	Latn				
ktw	Latn				
ktx	Latn				
kty	Latn				
ktz	Latn				
kua	Latn		Brai		
kub	Latn				
kuc	Latn				
kud	Latn				
kue	Latn				
kuf	Laoo				
kug	Latn				
kuh	Latn				
kui	Latn				
kuj	Latn	Arab			
kuk	Latn				
kul	Latn				
kum	Arab, Cyrl, Latn				
kun	Latn				
kuo	Latn				
kup	Latn				
kuq	Latn				
kur	Arab, Cyrl, Latn, Yezi, Armn				
kus	Latn				
kut	Latn				
kuu	Latn				
kuv	Latn				
kuw	Latn				
kux	Latn				
kuy	Latn				
kuz	Latn				
kva	Cyrl				
kvb	Latn				
kvc	Latn				
kvd	Latn				
kve	Latn				
kvf	Latn				
kvg	Latn				
kvh	Latn				
kvi	Latn				
kvj	Latn				
kvk	Zxxx				
kvl	Latn				
kvm	Latn				
kvn	Latn				
kvo	Latn				
kvp	Latn				
kvq	Latn, Mymr				
kvr	Latn, Rjng				
kvt	Mymr				
kvu					
kvv	Latn				
kvw	Latn				
kvx	Arab				
kvy	Kali				
kvz	Latn				
kwa	Latn				
kwb	Latn				
kwc	Latn				
kwd	Latn				
kwe	Latn				
kwf	Latn				
kwg	Latn				
kwh	Latn				
kwi	Latn				
kwj	Latn				
kwk	Latn				
kwl	Latn				
kwm	Latn				
kwn	Latn				
kwo	Latn				
kwp	Latn				
kwr	Latn				
kws	Latn				
kwt	Latn				
kwu	Latn				
kwv	Latn				
kww	Latn				
kwx					
kwy	Latn				
kwz	Latn				
kxa	Latn				
kxb	Latn				
kxc	Ethi		Latn		
kxd	Arab, Latn				
kxf	Mymr, Latn				
kxh					
kxi	Latn				
kxj	Latn				
kxk	Mymr				
kxl					
kxm	Thai		Khmr		
kxn	Latn				
kxo	Latn				
kxp	Arab		Gujr		
kxq	Latn				
kxr	Latn				
kxs					
kxt	Latn				
kxu	Orya				
kxv	Orya		Telu, Latn		
kxw	Latn				
kxx	Latn				
kxy	Latn				
kxz	Latn				
kya	Latn				
kyb	Latn				
kyc	Latn				
kyd	Latn				
kye	Latn				
kyf	Latn	Bété			
kyg	Latn				
kyh	Latn				
kyi	Latn				
kyj	Latn				
kyk	Latn				
kyl	Latn				
kym	Latn				
kyn	Latn				
kyo	Latn				
kyp					
kyq	Latn				
kyr	Latn				
kys	Latn				
kyt	Latn				
kyu	Kali, Latn, Mymr				
kyv	Deva				
kyw	Deva, Zzzz, Beng, Orya				
kyx	Latn				
kyy	Latn				
kyz	Latn				
kza	Latn				
kzb	Latn				
kzc	Latn				
kzd	Latn				
kze	Latn				
kzf	Latn				
kzg					
kzi	Latn				
kzj	Latn				
kzk	Latn				
kzl	Latn				
kzm	Latn				
kzn	Latn				
kzo	Latn				
kzp	Latn				
kzq					
kzr	Latn				
kzs	Latn				
kzu	Latn				
kzv	Latn				
kzw	Latn				
kzx	Latn				
kzy	Latn				
kzz	Latn				
laa	Latn				
lab	Lina				
lac	Latn				
lad	Cyrl, Hebr, Latn	Grek, Arab			
lae	Deva, Tibt				
laf					
lag	Latn				
lah	Arab	Guru	Latn, Khoj, Mahj		
lai	Latn				
laj	Latn				
lal	Latn				
lam	Latn				
lan	Latn				
lao	Laoo	Thai, Brai		Latn	
lap	Latn				
laq	Latn				
lar	Latn				
las	Latn				
lat	Latn				
lau	Latn				
lav	Latn, Brai				
law	Latn				
lax	Beng, Latn				
lay					
laz	Latn				
lba					
lbb	Latn				
lbc	Lisu				
lbe	Cyrl, Latn		Arab		
lbf	Deva, Tibt				
lbg					
lbi	Latn				
lbj	Arab, Tibt				
lbk	Latn				
lbl	Latn				
lbm	Deva				
lbn	Laoo, Latn				
lbo	Laoo, Latn				
lbq	Latn				
lbr	Deva				
lbs	Zxxx				
lbt	Latn				
lbu	Latn				
lbv	Latn				
lbw	Latn				
lbx	Latn				
lby	Latn				
lbz	Latn				
lcc	Latn				
lcd	Latn				
lce	Latn				
lcf	Latn				
lch	Latn				
lcl	Latn				
lcm	Latn				
lcp	Thai				
lcq	Latn				
lcs	Latn				
lda	Latn				
ldb	Latn				
ldd	Latn				
ldg	Latn				
ldh	Latn				
ldi	Latn				
ldj	Latn				
ldk	Latn				
ldl	Latn				
ldm	Latn				
ldn	Latn				
ldo	Latn				
ldp	Latn				
ldq	Latn				
lea	Latn				
leb	Latn				
lec	Latn				
led	Latn				
lee	Latn				
lef	Latn				
leh	Latn				
lei	Latn				
lej	Latn				
lek	Latn				
lel	Latn				
lem	Latn				
len	Latn				
leo	Latn				
lep	Lepc, Tibt				
leq	Latn				
ler	Latn				
les	Latn				
let	Latn				
leu	Latn				
lev	Latn				
lew	Latn				
lex	Latn				
ley	Latn				
lez	Cyrl, Latn	Arab	Aghb		
lfa	Latn				
lfn	Cyrl, Latn				
lga	Latn				
lgb	Latn				
lgg	Latn		Arab		
lgh	Latn				
lgi	Latn				
lgk	Latn				
lgl	Latn				
lgm	Latn				
lgn	Latn				
lgo	Latn				
lgq	Latn				
lgr	Latn				
lgs	Zxxx				
lgt	Latn				
lgu	Latn				
lgz	Latn				
lha	Latn				
lhh	Latn				
lhi	Latn				
lhl					
lhm	Deva				
lhn	Latn				
lhp					
lhs	Syrc				
lht	Latn				
lhu	Latn				
lia	Latn				
lib	Latn				
lic	Latn				
lid	Latn				
lie	Latn				
lif	Deva, Limb	Latn			
lig	Latn				
lih	Latn				
lij	Latn				
lik	Latn				
lil	Latn		Dupl		
lim	Latn				
lin	Latn	Mandombe			
lio	Latn				
lip	Latn				
liq	Latn				
lir	Latn				
lis	Lisu, Latn				
lit	Latn	Brai	Latf		
liu	Latn				
liv	Latn				
liw	Latn				
lix	Latn				
liy	Latn				
liz	Latn				
lja	Latn				
lje	Latn				
lji	Latn				
ljl	Latn				
ljp	Rjng, Latn				
ljw	Latn				
ljx	Latn				
lka	Latn				
lkb	Latn				
lkc	Latn				
lkd	Latn				
lke	Latn				
lkh	Tibt				
lki	Arab			Latn	
lkj	Latn				
lkl	Latn				
lkm	Latn				
lkn	Latn				
lko	Latn				
lkr	Latn				
lks	Latn				
lkt	Latn				
lku	Latn				
lky	Latn				
lla	Latn				
llb	Latn				
llc	Latn				
lld	Latn				
lle	Latn				
llf	Latn				
llg	Latn				
llh					
lli	Latn				
llj	Latn				
llk	Latn				
lll	Latn				
llm	Latn				
lln	Latn				
llp	Latn				
llq	Latn				
lls	Zxxx				
llu	Latn				
llx	Latn				
lma	Latn				
lmb	Latn				
lmc	Latn				
lmd	Latn				
lme	Latn				
lmf	Latn				
lmg	Latn				
lmh	Deva				
lmi	Latn				
lmj	Latn				
lmk	Latn, Mymr	Mtei			
lml	Latn				
lmn	Deva, Knda, Telu			Latn	
lmo	Latn				
lmp	Latn				
lmq	Latn				
lmr	Latn				
lmu	Latn				
lmv	Latn				
lmw	Latn				
lmx	Latn				
lmy	Latn				
lmz					
lna	Latn				
lnb	Latn				
lnd	Latn				
lng	Latn, Runr				
lnh	Latn				
lni	Latn				
lnj	Latn				
lnl	Latn				
lnm	Latn				
lnn	Latn				
lns	Latn				
lnu	Latn				
lnw	Latn				
lnz	Latn				
loa	Latn				
lob	Latn				
loc	Latn				
loe	Latn				
lof					
log	Latn				
loh	Latn				
loi	Latn				
loj	Latn				
lok	Latn				
lol	Latn				
lom	Loma, Latn				
lon	Latn				
loo	Latn				
lop	Latn				
loq	Latn				
lor	Latn				
los	Latn				
lot	Latn		Arab		
lou	Latn				
lov					
low	Latn				
lox	Latn				
loy	Deva, Tibt				
loz	Latn	Brai, Ditema			
lpa	Latn				
lpe	Latn				
lpn	Latn				
lpo	Plrd, Lisu				
lpx	Latn				
lqr	Latn				
lra	Latn				
lrc	Arab				
lre					
lrg	Latn				
lri	Latn				
lrk	Arab				
lrl	Arab				
lrm	Latn				
lrn	Latn				
lro	Latn				
lrr					
lrt	Latn				
lrv	Latn				
lrz	Latn				
lsa	Arab				
lsb	Zxxx				
lsc	Zxxx				
lsd	Hebr				
lse	Latn				
lsg	Zxxx				
lsh					
lsi	Latn				
lsl	Zxxx				
lsm	Latn				
lsn	Zxxx				
lso	Zxxx				
lsp	Zxxx				
lsr	Latn				
lss	Arab				
lst	Zxxx				
lsv	Zxxx				
lsw	Zxxx				
lsy	Zxxx				
ltc	Hant, Hans				
ltg	Latn				
lth	Latn				
lti	Latn				
ltn	Latn				
lto	Latn				
lts	Latn				
ltu	Latn				
ltz	Latn	Brai			
lua	Latn				
lub	Latn				
luc	Latn				
lud	Latn				
lue	Latn	Brai			
luf	Latn				
lug	Latn	Brai	Arab		
lui	Latn				
luj	Latn				
luk	Tibt				
lul	Latn				
lum	Latn				
lun	Latn				
luo	Latn	Luo			
lup	Latn				
luq	Latn				
lur	Latn				
lus	Beng, Latn		Brai		
lut	Latn				
luu	Deva				
luv	Arab				
luw	Latn				
luy	Latn				
luz	Arab				
lva	Latn				
lvi	Latn				
lvk	Latn				
lvl	Latn				
lvs	Latn			Cyrl	
lvu	Latn				
lwa	Latn				
lwe	Latn				
lwg	Latn				
lwh	Latn				
lwl	Thai				
lwm	Thai				
lwo	Latn				
lws	Zxxx				
lwt	Latn				
lwu					
lww	Latn				
lxm	Latn				
lya	Tibt				
lyg					
lyn	Latn				
lzh	Hant, Hans, Hani				
lzl	Latn				
lzn	Latn				
lzz	Latn, Geor				
maa	Latn				
mab	Latn				
mad	Arab, Latn	Java			
mae	Latn				
maf	Latn				
mag	Deva, Kthi			Latn	
mah	Latn				
mai	Tirh, Deva, Kthi, Newa			Latn	
maj	Latn				
mak	Maka, Bugi, Latn	Arab			
mal	Mlym, Arab, Latn, Brai	Vatteluttu, Kolezhuthu, Syrc, Hebr, Malayanma, Gran			
mam	Latn				
man	Arab, Latn, Nkoo				
maq	Latn				
mar	Deva, Modi, Brai			Latn	
mas	Latn				
mat	Latn				
mau	Latn				
mav	Latn				
maw	Latn		Arab		
max	Latn				
maz	Latn				
mba	Latn				
mbb	Latn				
mbc	Latn				
mbd	Latn				
mbe					
mbf	Latn				
mbh	Latn				
mbi	Latn				
mbj	Latn				
mbk	Latn				
mbl	Latn				
mbm	Latn				
mbn	Latn				
mbo	Latn				
mbp	Latn				
mbq	Latn				
mbr	Latn				
mbs	Latn				
mbt	Latn				
mbu	Latn				
mbv	Latn				
mbw	Latn				
mbx	Latn				
mby	Arab				
mbz	Latn				
mca	Latn				
mcb	Latn				
mcc	Latn				
mcd	Latn				
mce	Latn				
mcf	Latn				
mcg	Latn				
mch	Latn				
mci	Latn				
mcj	Latn				
mck	Latn				
mcl	Latn				
mcm	Latn				
mcn	Latn				
mco	Latn				
mcp	Latn				
mcq	Latn				
mcr	Latn				
mcs	Latn				
mct	Latn				
mcu	Latn		Laoo		
mcv	Latn				
mcw	Latn				
mcx	Latn				
mcy	Latn				
mcz	Latn				
mda	Latn				
mdb	Latn				
mdc	Latn				
mdd	Latn				
mde	Arab, Latn				
mdf	Cyrl				
mdg	Latn				
mdh	Latn	Arab			
mdi	Latn				
mdj	Latn				
mdk	Latn				
mdl	Zxxx				
mdm	Latn				
mdn	Latn				
mdp	Latn				
mdq	Latn				
mdr	Latn, Bugi				
mds	Latn				
mdt	Latn				
mdu	Latn				
mdv	Latn				
mdw	Latn				
mdx	Ethi		Latn		
mdy	Ethi		Latn		
mdz	Latn				
mea	Latn				
meb	Latn				
mec	Latn				
med	Latn				
mee	Latn				
mef					
meh	Latn				
mei					
mej	Latn				
mek	Latn				
mel	Latn				
mem	Latn				
men	Latn, Mend				
meo	Arab, Latn	Thai			
mep	Latn				
meq	Latn				
mer	Latn				
mes	Latn				
met	Latn				
meu	Latn	Brai			
mev	Latn				
mew	Latn				
mey	Arab, Latn				
mez	Latn				
mfa	Arab, Thai	Latn			
mfb	Latn				
mfc	Latn				
mfd	Latn				
mfe	Latn				
mff	Latn				
mfg	Arab, Latn				
mfh	Latn				
mfi	Latn		Arab		
mfj	Latn				
mfk	Latn				
mfl	Latn				
mfm	Latn				
mfn	Latn				
mfo	Latn				
mfp	Latn				
mfq	Latn	Bari			
mfr	Latn				
mfs	Zxxx				
mft	Latn				
mfu	Latn				
mfv	Latn				
mfw	Latn				
mfx	Ethi, Latn				
mfy	Latn				
mfz	Latn				
mga	Latg				
mgb	Latn				
mgc	Latn				
mgd	Latn		Arab		
mge	Latn				
mgf	Latn				
mgg	Latn				
mgh	Latn				
mgi	Latn				
mgj	Latn				
mgk	Latn				
mgl	Latn				
mgm	Latn				
mgn	Latn				
mgo	Latn				
mgp	Deva	Akkha, Latn	Brah		
mgq	Latn				
mgr	Latn				
mgs	Latn				
mgt	Latn				
mgu	Latn				
mgv	Latn				
mgw	Latn				
mgy	Latn				
mgz	Latn				
mha					
mhb	Latn				
mhc	Latn				
mhd	Latn				
mhe	Latn				
mhf	Latn				
mhg	Latn				
mhi	Latn				
mhj	Arab				
mhk	Latn				
mhl	Latn				
mhm	Latn				
mhn	Latn				
mho	Latn				
mhp	Latn				
mhq	Latn				
mhr	Cyrl				
mhs	Latn				
mht	Latn				
mhu	Latn				
mhv					
mhw	Latn				
mhx	Latn				
mhy	Latn				
mhz	Latn				
mia	Latn				
mib	Latn				
mic	Latn	Suckerfish			
mid	Mand				
mie	Latn				
mif	Latn				
mig	Latn				
mih	Latn				
mii	Latn				
mij	Latn				
mik	Latn				
mil	Latn				
mim	Latn				
min	Arab, Latn				
mio	Latn				
mip	Latn				
miq	Latn				
mir	Latn				
mis	Hatr, Latn				
mit	Latn				
miu	Latn				
miw	Latn				
mix	Latn				
miy	Latn				
miz	Latn				
mjb	Latn				
mjc	Latn				
mjd	Latn				
mje	Latn				
mjg	Latn				
mjh	Latn				
mji	Latn				
mjj	Latn				
mjk	Latn				
mjl	Deva, Takr, Latn				
mjm	Latn				
mjn	Latn				
mjo					
mjp					
mjq	Mlym				
mjr	Mlym				
mjs	Latn				
mjt	Deva, Beng				
mju	Telu				
mjv	Mlym				
mjw	Latn				
mjx	Beng, Latn				
mjy	Latn				
mjz	Deva				
mka	Latn				
mkb	Deva				
mkc	Latn				
mkd	Cyrl, Brai			Latn	
mke	Deva				
mkf	Latn				
mkg					
mki	Deva, Arab	Mahj			
mkj	Latn				
mkk	Latn				
mkl	Latn				
mkm	Thai				
mkn	Latn				
mko	Latn				
mkp	Latn				
mkq					
mkr	Latn				
mks	Latn				
mkt	Latn				
mku	Latn, Nkoo				
mkv	Latn				
mkw	Latn				
mkx	Latn				
mky	Latn				
mkz	Latn				
mla	Latn				
mlb	Latn				
mlc	Latn				
mld					
mle	Latn				
mlf	Latn, Thai				
mlg	Arab, Latn, Brai				
mlh	Latn				
mli	Latn				
mlj	Latn				
mlk	Latn				
mll	Latn				
mlm					
mln	Latn				
mlo	Latn				
mlp	Latn				
mlq	Arab, Latn				
mlr	Latn				
mls	Latn				
mlt	Latn, Brai		Arab		
mlu	Latn				
mlv	Latn				
mlw	Latn				
mlx	Latn				
mly					
mlz	Latn				
mma	Latn				
mmb	Latn				
mmc	Latn				
mmd	Hant, Hans, Latn				
mme	Latn				
mmf	Latn				
mmg	Latn				
mmh	Latn				
mmi	Latn				
mmj					
mmk					
mml					
mmm	Latn				
mmn	Latn				
mmo	Latn				
mmp	Latn				
mmq	Latn				
mmr	Latn				
mms					
mmt	Latn				
mmu	Latn				
mmv	Latn				
mmw	Latn				
mmx	Latn				
mmy	Latn				
mmz	Latn				
mna	Latn				
mnb	Latn				
mnc	Mong			Latn	
mnd	Latn				
mne	Latn				
mnf	Latn				
mng	Latn				
mnh	Latn				
mni	Beng, Latn, Mtei	Naoriya Phulo	Brai		
mnj	Arab				
mnk	Latn, Arab	Nkoo			
mnl	Latn				
mnm	Latn				
mnn	Latn				
mnp	Latn				
mnq	Latn				
mnr	Latn				
mns	Cyrl				
mnu	Latn				
mnv	Latn				
mnw	Mymr				
mnx	Latn				
mny	Latn				
mnz	Latn				
moa	Latn				
moc	Latn				
mod	Latn				
moe	Latn				
mog	Latn				
moh	Latn				
moi	Latn				
moj	Latn				
mok	Latn				
mol					
mom	Latn				
mon	Cyrl, Mong, Brai, Phag		Tibt	Soyo, Latn	
moo	Latn				
mop	Latn				
moq	Latn				
mor	Latn				
mos	Latn	Nkoo	Brai		
mot	Latn				
mou	Latn				
mov	Latn				
mow	Latn				
mox	Latn				
moy	Ethi, Latn				
moz	Latn				
mpa	Latn				
mpb	Latn				
mpc	Latn				
mpd	Latn				
mpe	Ethi, Latn				
mpf					
mpg	Latn				
mph	Latn				
mpi	Latn				
mpj	Latn				
mpk	Latn				
mpl	Latn				
mpm	Latn				
mpn	Latn				
mpo	Latn				
mpp	Latn				
mpq	Latn				
mpr	Latn				
mps	Latn				
mpt	Latn				
mpu	Latn				
mpv	Latn				
mpw	Latn				
mpx	Latn				
mpy	Latn				
mpz	Thai				
mqa	Latn				
mqb	Latn				
mqc	Latn				
mqe	Latn				
mqf	Latn				
mqg	Latn				
mqh	Latn				
mqi	Latn				
mqj	Latn				
mqk	Latn				
mql	Latn				
mqm	Latn				
mqn	Latn				
mqo	Latn				
mqp	Latn				
mqq	Latn				
mqr	Latn				
mqs	Latn				
mqt					
mqu	Latn				
mqv	Latn				
mqw	Latn				
mqx	Bugi, Latn				
mqy	Latn				
mqz	Latn				
mra	Thai				
mrb	Latn				
mrc	Latn				
mrd	Deva	Latn, Akkha			
mre	Zxxx				
mrf	Latn				
mrg	Latn, Beng, Deva				
mrh	Latn				
mri	Latn	Brai			
mrj	Cyrl				
mrk	Latn				
mrl	Latn				
mrm	Latn				
mrn	Latn				
mro	Mroo, Latn				
mrp	Latn				
mrq	Latn				
mrr	Deva				
mrs	Latn				
mrt	Latn				
mru	Latn				
mrv	Latn				
mrw	Arab, Latn				
mrx	Latn				
mry	Latn				
mrz	Latn				
msa	Arab, Latn, Thai, Brai	Pallava, Kawi, Rjng			
msb	Latn				
msc	Latn				
msd	Zxxx				
mse	Latn				
msf	Latn				
msg	Latn				
msh	Latn				
msi	Latn				
msj	Latn				
msk	Latn				
msl	Latn				
msm	Latn				
msn	Latn				
mso	Latn				
msp	Latn				
msq	Latn				
msr	Zxxx				
mss	Latn				
msu	Latn				
msv	Latn				
msw	Latn				
msx	Latn				
msy	Latn				
msz	Latn				
mta	Latn				
mtb	Latn				
mtc	Latn				
mtd	Latn				
mte	Latn				
mtf	Latn				
mtg	Latn				
mth	Latn				
mti	Latn				
mtj	Latn				
mtk	Latn				
mtl	Latn				
mtm	Cyrl				
mtn	Latn				
mto	Latn				
mtp	Latn				
mtq	Latn				
mtr	Deva			Latn	
mts	Latn				
mtt	Latn				
mtu	Latn				
mtv	Latn				
mtw	Latn				
mtx	Latn				
mty	Latn				
mtz					
mua	Latn				
mub	Latn				
muc	Latn				
mud	Cyrl				
mue	Latn				
mug	Latn				
muh	Latn				
mui	Latn				
muj	Latn				
muk	Tibt				
mum	Latn				
muo	Latn				
mup	Deva			Latn	
muq	Latn				
mur	Latn		Arab		
mus	Latn				
mut	Deva				
muu	Latn				
muv	Taml				
muw					
mux	Latn				
muy	Latn				
muz	Ethi, Latn				
mva	Latn				
mvb					
mvc					
mvd	Latn				
mve	Arab	Deva, Mahj		Latn	
mvf	Phag, Mong				
mvg	Latn				
mvh	Latn				
mvi					
mvj					
mvk	Latn				
mvl	Latn				
mvm					
mvn	Latn				
mvo	Latn				
mvp	Latn				
mvq	Latn				
mvr	Latn				
mvs	Latn				
mvt	Latn				
mvu	Latn				
mvv	Latn				
mvw	Latn				
mvx	Latn				
mvy	Arab				
mvz	Arab, Ethi				
mwa	Latn				
mwb	Latn				
mwc	Latn				
mwe	Latn				
mwf	Latn				
mwg	Latn				
mwh	Latn				
mwi	Latn				
mwk	Latn				
mwl	Latn				
mwm	Latn				
mwn	Latn				
mwo	Latn				
mwp	Latn				
mwq	Latn				
mwr	Deva, Mahj	Arab			
mws	Latn				
mwt	Mymr, Thai				
mwu	Latn				
mwv	Latn				
mww	Hmng, Hmnp, Latn, Laoo		Thai, Plrd		
mwx	Latn				
mwy	Latn				
mwz	Latn				
mxa	Latn				
mxb	Latn				
mxc	Latn				
mxd	Latn				
mxe	Latn				
mxf	Latn				
mxg	Latn				
mxh	Latn				
mxi	Latn				
mxj	Latn				
mxk	Latn				
mxl	Latn	Nkoo			
mxm	Latn				
mxn	Latn				
mxo	Latn				
mxp	Latn				
mxq	Latn				
mxr	Latn				
mxs	Latn				
mxt	Latn				
mxu	Latn				
mxv	Latn				
mxw	Latn				
mxx	Latn, Nkoo				
mxy	Latn				
mxz	Latn				
mya	Mymr, Brai				
myb	Latn				
myc	Latn				
mye	Latn				
myf	Latn				
myg	Latn				
myh	Latn				
myi					
myj	Latn				
myk	Latn				
myl	Latn				
mym	Ethi, Latn				
myo					
myp	Latn				
myq					
myr	Latn				
mys					
myu	Latn				
myv	Cyrl				
myw	Latn				
myx	Latn				
myy	Latn				
myz	Mand				
mza	Latn				
mzb	Arab, Tfng, Latn				
mzc	Zxxx				
mzd	Latn				
mze	Latn				
mzg	Zxxx				
mzh	Latn				
mzi	Latn				
mzj	Latn	Nkoo			
mzk	Latn				
mzl	Latn				
mzm	Latn				
mzn	Arab				
mzo	Latn				
mzp	Latn				
mzq	Latn				
mzr	Latn				
mzs					
mzt	Latn				
mzu	Latn				
mzv	Latn				
mzw	Latn				
mzx	Latn				
mzy	Zxxx				
mzz	Latn				
naa	Latn				
nab	Latn				
nac	Latn				
nae	Latn				
naf	Latn				
nag	Latn				
nah					
naj	Latn				
nak	Latn				
nal	Latn				
nam	Latn				
nan	Latn, Hant, Hans, Hani		Kana, Bopo		Arab
nao	Deva				
nap	Latn				
naq	Latn				
nar	Latn				
nas	Latn				
nat	Latn				
nau	Latn				
nav	Latn	Brai			
naw	Latn				
nax	Latn				
nay	Latn				
naz	Latn				
nba	Latn				
nbb	Latn				
nbc	Latn				
nbd	Latn				
nbe	Latn				
nbf					
nbg					
nbh	Latn				
nbi	Latn				
nbj	Latn				
nbk	Latn				
nbl	Latn, Brai				
nbm	Latn				
nbn	Latn				
nbo	Latn				
nbp	Latn				
nbq	Latn				
nbr	Latn				
nbs	Zxxx				
nbt	Deva, Latn				
nbu	Latn				
nbv	Latn				
nbw	Latn				
nby	Latn				
nca	Latn				
ncb	Deva, Latn				
ncc	Latn				
ncd	Deva				
nce	Latn				
ncf	Latn				
ncg	Latn	NAPA			
nch	Latn				
nci	Latn				
ncj	Latn				
nck	Latn				
ncl	Latn				
ncm	Latn				
ncn	Latn				
nco	Latn				
ncq	Laoo, Thai				
ncr	Latn				
ncs	Zxxx				
nct	Beng, Latn				
ncu	Latn				
ncx	Latn				
ncz	Latn				
nda	Latn				
ndb	Latn				
ndc	Latn				
ndd	Latn				
nde	Latn				
ndf	Cyrl				
ndg	Latn				
ndh	Latn				
ndi	Latn				
ndj	Latn				
ndk	Latn				
ndl	Latn				
ndm	Latn				
ndn	Latn				
ndo	Latn				
ndp	Latn				
ndq	Latn				
ndr	Latn				
nds	Latn		Runr		
ndt	Latn				
ndu	Latn				
ndv	Latn				
ndw	Latn				
ndx	Latn				
ndy	Latn				
ndz	Latn				
nea	Latn				
neb	Latn				
nec	Latn				
ned	Latn				
nee	Latn				
nef					
neg	Cyrl				
neh	Tibt				
nei	Xsux				
nej	Latn				
nek	Latn				
nem	Latn				
nen	Latn				
neo	Latn				
nep	Deva, Newa, Brai				
neq	Latn				
ner	Latn				
nes					
net	Latn				
neu	Latn				
nev					
new	Deva, Newa, Ranj	Bhujimol			
nex	Latn				
ney	Latn				
nez	Latn				
nfa	Latn				
nfd	Latn				
nfl	Latn				
nfr	Latn				
nfu	Latn				
nga	Latn				
ngb	Latn				
ngc	Latn				
ngd	Latn				
nge	Latn				
ngg	Latn				
ngh	Latn				
ngi	Latn				
ngj	Latn				
ngk	Latn				
ngl	Latn				
ngm	Latn				
ngn	Latn				
ngo	Latn				
ngp	Latn				
ngq	Latn				
ngr	Latn				
ngs	Latn				
ngt	Laoo				
ngu	Latn				
ngv	Latn				
ngw	Latn				
ngx	Latn				
ngy	Latn				
ngz	Latn				
nha	Latn				
nhb	Latn				
nhc	Latn				
nhd	Latn				
nhe	Latn				
nhf	Latn				
nhg	Latn				
nhh					
nhi	Latn				
nhj					
nhk	Latn				
nhm	Latn				
nhn	Latn				
nho	Latn				
nhp	Latn				
nhq	Latn				
nhr	Latn				
nht	Latn				
nhu	Latn				
nhv	Latn				
nhw	Latn				
nhx	Latn				
nhy	Latn				
nhz	Latn				
nia	Latn				
nib	Latn				
nid	Latn				
nie	Latn				
nif	Latn				
nig	Latn				
nih	Latn				
nii	Latn				
nij	Latn				
nik					
nil	Latn				
nim	Latn				
nin	Latn				
nio	Cyrl, Latn				
niq	Latn				
nir	Latn				
nis	Latn				
nit	Telu				
niu	Latn				
niv	Cyrl, Latn				
niw	Latn				
nix	Latn				
niy	Latn				
niz	Latn				
nja	Latn				
njb	Latn				
njd	Latn				
njh	Latn				
nji	Latn				
njj	Latn				
njl	Latn				
njm	Latn				
njn	Latn				
njo	Latn				
njr	Latn				
njs	Latn				
njt	Latn				
nju	Latn				
njx	Latn				
njy	Latn				
njz	Latn, Beng				
nka	Latn				
nkb	Latn				
nkc	Latn				
nkd	Latn				
nke	Latn				
nkf	Latn				
nkg	Latn				
nkh	Latn				
nki	Beng, Latn				
nkj	Latn				
nkk	Latn				
nkm	Latn				
nkn	Latn				
nko	Latn				
nkp					
nkq	Latn				
nkr	Latn				
nks	Latn				
nkt	Latn				
nku	Latn				
nkv	Latn				
nkw	Latn				
nkx	Latn				
nkz	Latn				
nla	Latn				
nlc	Latn				
nld	Latn, Brai				
nle	Latn				
nlg	Latn				
nli	Arab				
nlj	Latn				
nlk	Latn				
nll					
nlm	Arab				
nlo	Latn				
nlq	Latn				
nlu	Latn				
nlv	Latn				
nlw	Latn				
nlx	Deva				
nly	Latn				
nlz	Latn				
nma	Latn				
nmb	Latn				
nmc	Latn				
nmd	Latn				
nme	Latn				
nmf	Latn	Mtei			
nmg	Latn				
nmh	Latn				
nmi	Latn				
nmj	Latn				
nmk	Latn				
nml	Latn				
nmm	Deva, Tibt				
nmn	Latn				
nmo	Latn, Beng				
nmp	Latn				
nmq	Latn				
nmr	Latn				
nms	Latn				
nmt	Latn				
nmu	Latn				
nmv	Latn				
nmw	Latn				
nmx	Latn				
nmy					
nmz	Latn				
nna	Latn				
nnb	Latn				
nnc	Latn				
nnd	Latn				
nne	Latn				
nnf	Latn				
nng	Beng, Latn				
nnh	Latn				
nni	Latn				
nnj	Latn				
nnk	Latn				
nnl	Latn				
nnm	Latn				
nnn	Latn				
nno	Latn				
nnp	Deva, Wcho, Latn				
nnq	Latn				
nnr	Latn				
nnt	Latn				
nnu	Latn				
nnv	Latn				
nnw	Latn				
nny	Latn				
nnz	Latn				
noa	Latn				
nob	Latn				
noc	Latn				
nod	Lana, Thai				
noe	Deva			Latn	
nof	Latn				
nog	Cyrl	Latn			
noh	Latn				
noi	Deva				
noj	Latn				
nok	Latn				
nol					
nom	Latn				
non	Runr, Latn				
nop	Latn				
noq	Latn				
nor	Latn		Runr		
nos	Yiii				
not	Latn				
nou	Latn				
nov	Latn				
now	Latn				
noy	Latn				
noz					
npa					
npb	Tibt				
npg	Latn				
nph	Latn				
npi	Deva	Brai		Latn	
npl	Latn				
npn	Latn				
npo	Latn				
nps	Latn				
npu	Latn				
npx	Latn				
npy	Latn				
nqg	Latn				
nqk	Latn				
nql	Latn				
nqm	Latn				
nqn	Latn				
nqo	Nkoo				
nqq	Latn				
nqt	Latn				
nqy	Latn				
nra	Latn				
nrb	Latn				
nrc					
nre	Latn				
nrf	Latn				
nrg	Latn				
nri	Latn				
nrk	Latn				
nrl	Latn				
nrm	Latn				
nrn	Runr, Latn				
nrp	Latn				
nrr					
nrt					
nru	Latn, Hant, Nkdb, Nkgb, Hans				
nrx	Latn				
nrz	Latn				
nsa	Latn				
nsb	Latn				
nsc	Latn				
nsd	Yiii				
nse	Latn				
nsf	Yiii				
nsg	Latn				
nsh	Latn				
nsi	Zxxx				
nsk	Cans		Latn		
nsl	Zxxx				
nsm	Latn				
nsn	Latn				
nso	Latn, Brai				
nsp	Zxxx				
nsq	Latn				
nsr	Zxxx				
nss	Latn				
nst	Tnsa, Latn				
nsu	Latn				
nsv	Yiii				
nsw	Latn				
nsx	Latn				
nsy	Latn				
nsz	Latn				
ntd	Latn				
nte	Latn				
ntg	Latn				
nti	Latn				
ntj	Latn				
ntk	Latn				
ntm	Latn				
nto	Latn				
ntp	Latn				
ntr	Latn				
ntu	Latn				
ntw					
ntx	Latn				
nty	Yiii				
ntz	Arab				
nua	Latn				
nuc	Latn				
nud	Latn				
nue	Latn				
nuf	Latn				
nug	Latn				
nuh	Latn				
nui	Latn				
nuj	Latn				
nuk	Latn				
nul	Latn				
num	Latn				
nun	Latn				
nuo	Latn				
nup	Arab, Latn				
nuq	Latn				
nur	Latn				
nus	Latn				
nut	Latn	Sawndip, Hani			
nuu	Latn				
nuv	Latn				
nuw	Latn				
nux	Latn				
nuy	Latn				
nuz	Latn				
nvh	Latn				
nvm	Latn				
nvo	Latn				
nwa					
nwb	Latn				
nwc	Sidd, Deva, Ranj, Brah, Newa				
nwe	Latn				
nwg	Latn				
nwi	Latn				
nwm	Latn				
nwo	Latn				
nwr	Latn				
nww	Latn				
nwx	Deva				
nwy					
nxa	Latn				
nxd	Latn				
nxe	Latn				
nxg	Latn				
nxi	Latn				
nxk					
nxl	Latn				
nxm	Tfng				
nxn	Latn				
nxo	Latn				
nxq	Latn, Hant, Nkdb, Nkgb, Hans, Lisu				
nxr	Latn				
nxx	Latn				
nya	Latn, Brai	Mwangwego			
nyb	Latn				
nyc	Latn				
nyd	Latn				
nye	Latn				
nyf	Latn				
nyg	Latn				
nyh	Latn				
nyi	Latn				
nyj	Latn				
nyk	Latn				
nyl	Thai				
nym	Latn				
nyn	Latn				
nyo	Latn				
nyp	Latn				
nyq	Arab				
nyr	Latn				
nys	Latn				
nyt	Latn				
nyu	Latn				
nyv	Latn				
nyw	Zzzz, Latn, Thai				
nyx	Latn				
nyy	Latn				
nza	Latn				
nzb	Latn				
nzd	Latn				
nzi	Latn				
nzk	Latn				
nzm	Latn				
nzr	Latn				
nzs	Zxxx				
nzu	Latn				
nzy	Latn				
nzz	Latn				
oaa	Cyrl				
oac	Cyrl				
oar	Syrc				
oav	Geor				
obi	Latn				
obk	Latn				
obl	Latn				
obm	Phnx				
obo	Latn				
obr	Mymr				
obt	Latn				
obu	Latn				
oca	Latn				
occ					
och					
oci	Latn				
ocm					
oco	Latn				
ocu	Latn				
oda	Latn				
odk	Arab				
odt	Latn				
odu	Latn				
ofo					
ofs	Latn, Runr				
ofu	Latn				
ogb	Latn				
ogc	Latn				
oge	Geok				
ogg	Latn				
ogo	Latn				
ogu	Latn				
oht	Xsux				
ohu	Latn, Hung				
oia	Latn				
oie	Latn				
oin	Latn				
ojb	Latn, Cans				
ojc	Latn				
oji	Cans, Latn	Great Lakes Algonquian			
ojp					
ojs	Cans		Latn		
ojv	Latn				
ojw	Cans, Latn				
oka	Latn		Dupl		
okb	Latn				
okc	Latn				
okd	Latn				
oke	Latn				
okg	Latn				
okh					
oki	Latn				
okj					
okk	Latn				
okl	Zxxx				
okm	Hang				
okn					
oko	Hani				
okr	Latn				
oks	Latn				
oku	Latn				
okv	Latn				
okx	Latn				
okz	Khmr				
ola	Deva, Tibt				
old	Latn				
ole	Tibt				
olk	Latn				
olm	Latn				
olo	Latn	Cyrl			
olr	Latn				
olt	Latn				
olu	Latn				
oma	Latn				
omb	Latn				
omc	Latn				
omg	Latn				
omi	Latn				
omk	Cyrl				
oml	Latn				
omn	Lina				
omo	Latn				
omp	Mtei				
omr	Modi				
omt	Latn				
omu	Latn				
omw	Latn				
omx	Mymr				
omy					
ona	Latn				
onb					
one	Latn				
ong	Latn				
oni	Latn				
onj	Latn				
onk	Latn				
onn	Latn				
ono	Latn				
onp	Deva, Latn				
onr	Latn				
ons	Latn				
ont	Latn				
onu	Latn				
onw	Copt				
onx	Latn				
ood	Latn				
oog					
oon	Deva				
oor	Latn				
oos					
opa	Latn				
ope					
opk	Latn				
opm	Latn				
opo	Latn				
opt	Latn				
opy	Latn				
ora	Latn				
orc	Latn				
ore	Latn				
org	Latn				
orh	Latn				
ori	Orya, Brai	Kalinga		Latn	
orm	Latn		Arab, Ethi		
orn	Latn				
oro	Latn				
orr	Latn				
ors	Latn				
ort	Telu				
oru	Arab				
orv	Cyrl				
orw	Latn				
orx	Latn				
ory	Orya				
orz	Latn				
osa	Osge, Latn				
osc	Ital, Latn				
osi	Java	Arab		Latn	
osn	Sund				
oso	Latn				
osp	Latn				
oss	Cyrl, Latn, Geor				
ost	Latn				
osu	Latn				
osx	Latn				
ota	Arab				
otb	Tibt				
otd	Latn				
ote	Latn				
oti	Latn				
otk	Orkh				
otl	Latn				
otm	Latn				
otn	Latn				
otq	Latn				
otr	Latn				
ots	Latn				
ott	Latn				
otu	Latn				
otw	Latn				
otx	Latn				
oty	Gran				
otz	Latn				
oua					
oub	Latn				
oue	Latn				
oui	Ougr, Mong				
oum	Latn				
ovd	Latn	Dalecarlian runes, Runr			
owi	Latn				
owl	Latn				
oyb					
oyd	Latn				
oym	Latn				
oyy	Latn				
ozm	Latn				
pab	Latn				
pac	Laoo, Latn				
pad	Latn				
pae	Latn				
paf	Latn				
pag	Latn	Kurítan	Brai		
pah	Latn				
pai	Latn				
pak	Latn				
pal	Phlp, Phli				
pam	Latn	Kulitan	Brai		
pan	Guru, Arab, Mahj	Takr, Landa, Brai	Khoj	Latn	
pao	Latn				
pap	Latn				
paq	Cyrl				
par	Latn				
pas	Latn				
pau	Latn				
pav	Latn				
paw	Latn				
pax	Latn				
pay	Latn				
paz	Latn				
pbb	Latn				
pbc	Latn				
pbe	Latn				
pbf	Latn				
pbg	Latn				
pbh	Latn				
pbi	Latn				
pbl	Latn				
pbm	Latn				
pbn	Latn				
pbo	Latn				
pbp	Latn				
pbr	Latn				
pbs	Latn				
pbt	Arab				
pbu	Arab				
pbv	Latn				
pby	Latn				
pca	Latn				
pcb	Khmr				
pcc	Hani, Latn	Sawndip			
pcd	Latn				
pce	Mymr	Tale	Thai		
pcf	Mlym				
pcg	Knda, Taml, Mlym				
pch	Deva				
pci	Deva, Orya				
pcj	Telu				
pck	Latn				
pcl					
pcm	Latn				
pcn	Latn				
pcp	Latn				
pcr					
pcw	Latn				
pda	Latn				
pdc	Latn				
pdi					
pdn	Latn				
pdo	Latn				
pdt	Latn				
pdu	Latn		Mymr		
pea	Latn				
peb	Latn				
pec					
ped	Latn				
pee	Latn				
pef					
peg	Orya				
peh					
pei	Latn				
pej					
pek	Latn				
pel	Latn				
pem	Latn				
peo	Xpeo				
pep	Latn				
peq	Latn				
pes	Arab				
pev	Latn				
pex	Latn				
pey	Latn				
pez	Latn				
pfa	Latn				
pfe	Latn				
pfl	Latn				
pga	Latn				
pgd	Khar				
pgg	Deva				
pgi	Latn				
pgk	Latn				
pgl	Ogam				
pgn	Ital				
pgs	Latn				
pgu	Latn				
pgz	Zxxx				
pha					
phd	Deva				
phg	Latn				
phh	Latn				
phj					
phk	Mymr				
phl	Arab				
phm	Latn				
phn	Phnx				
pho	Laoo				
phq					
phr	Arab			Latn	
pht	Thai				
phu	Lana, Laoo, Thai				
phv	Arab				
phw	Deva				
pia	Latn				
pib	Latn				
pic	Latn				
pid	Latn				
pie					
pif	Latn				
pig	Latn				
pih	Latn				
pii	Latn				
pij	Latn				
pil	Latn				
pim	Latn				
pin	Latn				
pio	Latn				
pip	Latn				
pir	Latn				
pis	Latn				
pit	Latn				
piu	Latn				
piv	Latn				
piw	Latn				
pix	Latn				
piy	Latn				
piz	Latn				
pjt	Latn				
pka	Brah				
pkb	Latn				
pkc					
pkg	Latn				
pkh	Deva, Latn				
pkn	Latn				
pko	Latn				
pkp	Latn				
pkr	Mlym				
pks	Zxxx				
pkt					
pku	Latn				
pla	Latn				
plb	Latn				
plc	Latn				
pld	Latn				
ple	Latn				
plg	Latn				
plh	Latn				
pli	Khar, Khmr, Thai, Deva, Brah, Sinh, Mymr				
plj	Latn				
plk	Arab				
pll	Mymr	Tale			
pln	Latn				
plo	Latn				
plp	Deva				
plq					
plr	Latn				
pls	Latn				
plt	Latn				
plu	Latn				
plv	Latn				
plw	Latn	Tagb			
ply					
plz	Latn				
pma	Latn				
pmb	Latn				
pmd	Latn				
pme	Latn				
pmf	Latn				
pmh	Brah				
pmi	Latn				
pmj	Latn				
pmk					
pml	Latn				
pmm	Latn				
pmn	Latn				
pmo	Latn				
pmq	Latn				
pmr	Latn				
pms	Latn				
pmt	Latn				
pmu					
pmw	Latn				
pmx	Latn				
pmy	Latn				
pmz	Latn				
pna	Latn				
pnb	Arab, Mahj	Brai			
pnc	Latn				
pnd	Latn				
pne	Latn				
png	Latn				
pnh	Latn				
pni	Latn				
pnj	Latn				
pnk	Latn				
pnl	Latn				
pnm	Latn				
pnn	Latn				
pno	Latn				
pnp	Latn				
pnq	Latn				
pnr	Latn				
pns	Latn				
pnt	Cyrl, Latn, Grek				
pnu					
pnv	Latn				
pnw	Latn				
pnx					
pny	Latn				
pnz	Latn				
poc	Latn				
poe	Latn				
pof	Latn				
pog	Latn				
poh	Latn				
poi	Latn				
pok	Latn				
pol	Latn		Brai		
pom	Latn				
pon	Latn				
poo	Latn				
pop	Latn				
poq	Latn				
por	Latn, Brai				
pos	Latn				
pot	Latn	Great Lakes Algonquian			
pov	Latn				
pow	Latn				
pox					
poy	Latn				
ppa					
ppe	Latn				
ppi	Latn				
ppk	Latn				
ppl	Latn				
ppm	Latn				
ppn	Latn				
ppo	Latn				
ppp	Latn				
ppq	Latn				
pps	Latn				
ppt	Latn				
ppu					
pqa	Latn				
pqm	Latn				
pra	Khar				
prb					
prc	Arab				
prd	Arab				
pre	Latn				
prf	Latn				
prg	Latn				
prh	Latn				
pri	Latn				
prk	Latn	Mymr, Hani			
prl	Zxxx				
prm	Latn				
prn	Arab				
pro	Latn				
prp	Gujr				
prq	Latn				
prr	Latn				
prs	Arab				
prt	Thai				
pru	Latn				
prw	Latn				
prx	Arab, Tibt				
prz	Zxxx				
psa	Latn				
psc	Zxxx				
psd	Zxxx				
pse	Latn				
psg	Zxxx				
psh	Arab				
psi	Arab				
psl	Zxxx				
psm	Latn				
psn	Latn				
pso	Zxxx				
psp	Zxxx				
psq	Latn				
psr	Zxxx				
pss	Latn				
pst	Arab				
psu	Deva, Brah				
psw	Latn				
psy					
pta	Latn				
pth	Latn				
pti	Latn				
ptn	Latn				
pto	Latn				
ptp	Latn				
ptq					
ptr	Latn				
ptt	Latn				
ptu	Latn				
ptv	Latn				
ptw					
pty					
pua	Latn				
pub	Latn				
puc	Latn				
pud	Latn				
pue	Latn				
puf	Latn				
pug	Latn				
pui	Latn				
puj	Latn				
puk					
pum	Deva				
pun					
puo	Latn				
pup	Latn				
puq	Latn				
pur	Latn				
pus	Arab			Latn	
put	Latn				
puu	Latn				
puw	Latn				
pux	Latn				
puy	Latn				
pwa	Latn				
pwb	Latn				
pwg	Latn				
pwi					
pwm	Latn				
pwn	Latn				
pwo	Mymr				
pwr	Deva				
pww	Thai				
pxm	Latn				
pye	Latn				
pym	Latn				
pyn	Latn				
pys	Zxxx				
pyu	Latn		Hani		
pyx	Mymr				
pyy	Latn				
pze	Latn				
pzh	Latn				
pzn	Latn				
qua	Latn				
qub	Latn				
quc	Latn				
qud	Latn				
que	Latn				
quf	Latn				
qug	Latn				
quh	Latn				
qui	Latn				
quk	Latn				
qul	Latn				
qum	Latn				
qun	Latn				
qup	Latn				
quq	Latn				
qur	Latn				
qus	Latn				
quv	Latn				
quw	Latn				
qux	Latn				
quy	Latn				
quz	Latn				
qva	Latn				
qvc	Latn				
qve	Latn				
qvh	Latn				
qvi	Latn				
qvj	Latn				
qvl	Latn				
qvm	Latn				
qvn	Latn				
qvo	Latn				
qvp	Latn				
qvs	Latn				
qvw	Latn				
qvy					
qvz	Latn				
qwa	Latn				
qwc	Latn				
qwh	Latn				
qwm	Cyrl, Latn, Runr				
qws	Latn				
qwt	Latn				
qxa	Latn				
qxc	Latn				
qxh	Latn				
qxl	Latn				
qxn	Latn				
qxo	Latn				
qxp	Latn				
qxq	Arab			Latn	
qxr	Latn				
qxs					
qxt	Latn				
qxu	Latn				
qxw	Latn				
qya	Teng, Sara, Latn, Cirt				
qyp	Latn				
raa	Deva				
rab	Deva				
rac	Latn				
rad	Latn				
rae					
raf	Deva				
rag	Latn				
rah	Beng, Latn				
rai	Latn				
raj	Deva		Latn	Sind	
rak	Latn				
ral					
ram	Latn				
ran	Latn				
rao	Latn				
rap	Latn	Roro			
raq					
rar	Latn				
ras					
rat					
rau					
rav	Deva				
raw	Latn				
rax	Latn				
ray	Latn				
raz	Latn				
rbb	Mymr	Tale			
rbk	Latn				
rbl	Latn				
rbp	Latn				
rcf	Latn				
rdb	Arab				
rea	Latn				
reb	Latn				
ree	Latn				
reg	Latn				
rei	Telu, Orya				
rej	Latn, Rjng				
rel	Latn				
rem	Latn				
ren	Latn				
rer					
res	Latn				
ret	Latn				
rey	Latn				
rga	Latn				
rge					
rgk					
rgn	Latn				
rgr	Latn				
rgs	Latn				
rgu	Latn				
rhg	Arab, Rohg, Mymr, Latn	Beng			
rhp	Latn				
ria	Latn	Koloma, Beng			
rib	Zxxx				
rie					
rif	Arab, Tfng, Latn				
ril	Latn				
rim	Latn				
rin	Latn				
rir	Latn				
rit	Latn				
riu	Latn				
rjb					
rjg	Latn				
rji	Deva				
rjs	Deva	Beng			
rka	Khmr				
rkb	Latn				
rkh	Latn				
rki	Mymr				
rkm	Latn				
rkt	Deva, Beng			Latn	
rkw	Latn				
rma	Latn				
rmb	Latn				
rmc	Latn				
rmd	Latn				
rme	Latn				
rmf	Latn				
rmg	Latn				
rmh	Latn				
rmi	Armn				
rmk	Latn				
rml	Cyrl		Latn		
rmm	Latn				
rmn	Latn, Cyrl, Grek				
rmo	Latn				
rmp	Latn				
rmq	Latn				
rms	Zxxx				
rmt	Arab	Latn, Hebr			
rmu	Latn				
rmv					
rmw	Latn				
rmx	Latn				
rmy	Cyrl, Latn				
rmz	Mymr, Beng				
rnb	Zxxx				
rnd	Latn				
rng	Latn				
rnl	Latn				
rnn	Latn				
rnp					
rnr	Latn				
rnw	Latn				
rob	Latn				
roc	Latn				
rod	Latn				
roe	Latn				
rof	Latn				
rog	Latn				
roh	Latn				
rol	Latn				
rom	Cyrl, Latn				
ron	Cyrl, Cyrs, Brai, Latn		Dupl		
roo	Latn				
rop	Latn				
ror	Latn				
rou	Latn				
row	Latn				
rpn	Latn				
rpt	Latn				
rri	Latn				
rro	Latn				
rrt	Latn				
rsb					
rsi	Zxxx				
rsk	Cyrl				
rsl	Zxxx				
rsm	Zxxx				
rsn	Zxxx				
rsw	Latn				
rtc	Latn				
rth	Latn				
rtm	Latn				
rts					
rtw	Deva			Guru	
rub	Latn				
ruc	Latn				
rue	Cyrl, Latn				
ruf	Latn				
rug	Latn				
ruh					
rui	Latn				
ruk	Latn				
run	Latn		Brai		
ruo	Latn				
rup	Latn		Grek		
ruq	Latn			Cyrl	
rus	Cyrl, Brai			Latn	
rut	Cyrl		Latn		
ruu	Latn				
ruy	Latn				
ruz	Latn				
rwa	Latn				
rwk	Latn				
rwl	Latn				
rwm	Latn				
rwo	Latn				
rwr	Deva	Mahj, Arab		Latn	
rxd	Latn				
rxw	Latn				
ryn					
rys					
ryu	Kana	Jpan, Hani, Hira, Latn			
rzh					
saa	Latn				
sab	Latn				
sac	Latn				
sad	Latn				
sae	Latn				
saf	Latn				
sag	Latn				
sah	Cyrl, Latn, Cyrs				
saj	Latn				
sak	Latn				
sam	Syrc, Hebr, Samr				
san	Bhks, Deva, Gran, Shrd, Sidd, Latn	Brah	Mymr, Tirh, Newa, Khar, Sinh, Nand, Kawi		
sao	Latn				
saq	Latn				
sar	Latn				
sas	Latn, Bali				
sat	Deva, Latn, Olck, Beng, Orya				
sau	Latn				
sav	Arab, Latn				
saw	Latn				
sax	Latn				
say	Latn				
saz	Deva, Telu, Saur, Taml				
sba	Latn				
sbb	Latn				
sbc	Latn				
sbd	Latn				
sbe	Latn				
sbf					
sbg	Latn				
sbh	Latn				
sbi	Latn				
sbj	Latn				
sbk	Latn				
sbl	Latn				
sbm	Latn				
sbn	Arab				
sbo	Latn				
sbp	Latn				
sbq	Latn				
sbr	Latn				
sbs	Latn				
sbt	Latn				
sbu	Deva, Tibt				
sbv	Latn				
sbw	Latn				
sbx	Latn				
sby	Latn				
sbz	Latn				
scb	Latn				
scc					
sce	Arab, Latn				
scf	Latn				
scg	Latn				
sch	Latn				
sci	Latn				
sck	Deva	Kthi	Beng	Latn	
scl	Arab			Latn	
scn	Latn				
sco	Latn		Runr		
scp	Deva				
scq					
scr					
scs	Cans, Latn				
sct	Laoo				
scu	Takr				
scv	Latn				
scw	Latn				
scx	Grek				
sda	Latn				
sdb	Arab				
sdc	Latn				
sde	Latn				
sdf	Arab				
sdg	Arab				
sdh	Arab				
sdj	Latn				
sdk	Latn				
sdl	Zxxx				
sdm	Latn				
sdn	Latn				
sdo	Latn				
sdp					
sdq	Latn				
sdr	Deva, Beng, Latn	Kthi			
sds	Arab				
sdt					
sdu	Latn				
sdx	Latn				
sdz	Latn				
sea	Latn				
seb	Latn				
sec	Latn				
sed	Latn				
see	Latn				
sef	Latn				
seg	Latn				
seh	Latn				
sei	Latn				
sej	Latn				
sek	Cans, Latn				
sel	Cyrl				
sen	Latn				
seo	Latn				
sep	Latn				
seq	Latn				
ser	Latn				
ses	Latn				
set	Latn				
seu	Latn				
sev	Latn				
sew	Latn				
sey	Latn				
sez	Latn				
sfb	Zxxx				
sfe	Latn				
sfm	Plrd				
sfs	Zxxx				
sfw	Latn				
sga	Ogam, Latn				
sgb	Latn				
sgc	Latn				
sgd	Latn				
sge	Latn				
sgg	Zxxx				
sgh	Arab, Cyrl, Latn				
sgi	Latn				
sgj	Deva				
sgk					
sgm	Latn				
sgn	Zxxx				
sgp	Latn				
sgr	Arab				
sgs	Latn				
sgt	Tibt				
sgu	Latn				
sgw	Ethi				
sgx	Zxxx				
sgy	Arab				
sgz	Latn				
sha	Latn				
shb	Latn				
shc	Latn				
shd	Arab				
she	Latn				
shg	Latn				
shh	Latn				
shi	Arab, Tfng, Latn				
shj	Latn				
shk	Latn		Arab		
shl					
shm	Arab				
shn	Mymr		Tale, Thai		
sho	Latn				
shp	Latn				
shq	Latn				
shr	Latn				
shs	Latn	Dupl			
sht	Latn				
shu	Arab		Latn		
shv	Arab				
shw	Latn				
shx					
shy	Tfng, Latn		Arab		
shz	Latn				
sia	Cyrl				
sib	Latn				
sid	Latn		Ethi		
sie	Latn				
sif	Latn				
sig	Latn				
sih	Latn				
sii	Latn				
sij	Latn				
sik	Latn				
sil	Latn				
sim	Latn				
sin	Sinh, Brai			Latn	
sip	Tibt				
siq	Latn				
sir	Latn				
sis	Latn				
siu	Latn				
siv	Latn				
siw	Latn				
six	Latn				
siy	Arab				
siz	Arab				
sja	Latn				
sjb	Latn				
sjd	Cyrl				
sje	Latn				
sjg	Latn				
sjk	Latn				
sjl	Latn				
sjm	Latn				
sjn	Teng, Cirt				
sjo	Latn, Mong		Cyrl		
sjp	Deva, Beng			Latn	
sjr	Latn				
sjs	Latn				
sjt	Cyrl, Latn				
sju	Latn				
sjw	Latn				
ska	Latn				
skb	Thai				
skc	Latn				
skd	Latn				
ske	Latn				
skf	Latn				
skg	Latn	Arab, Brai			
skh	Latn				
ski	Latn				
skj	Deva				
skm	Latn				
skn	Latn				
sko	Latn				
skp	Latn				
skq	Latn				
skr	Arab		Deva, Khoj, Guru, Mult	Latn	
sks	Latn				
skt	Latn				
sku	Latn				
skv	Latn				
skw	Latn				
skx	Latn				
sky	Latn				
skz	Latn				
slc	Latn				
sld	Latn				
sle					
slf	Zxxx				
slg	Latn				
slh	Latn				
sli	Latn				
slj	Latn				
slk	Latn, Brai				
sll	Latn				
slm	Latn				
sln	Latn				
slp	Latn				
slq	Arab				
slr	Latn	Hani		Cyrl	
sls	Zxxx				
slt					
slu	Latn				
slv	Latn, Brai				
slw	Latn				
slx	Latn				
sly	Latn				
slz	Latn				
sma	Latn				
smb	Latn				
smc	Latn				
sme	Latn	Brai	Cyrl		
smf	Latn				
smg	Latn				
smh	Yiii				
smj	Latn				
smk	Latn	Tglg			
sml	Latn				
smm					
smn	Latn				
smo	Latn	Brai			
smp	Arab, Hebr, Samr				
smq	Latn				
smr	Latn				
sms	Latn		Cyrl		
smt	Latn				
smu	Khmr				
smv					
smw	Latn				
smx	Latn				
smy	Arab				
smz	Latn				
sna	Latn, Brai	Arab			
snb					
snc	Latn				
snd	Guru, Arab, Sind, Deva		Khoj	Latn	
sne	Latn				
snf	Latn				
sng	Latn		Brai		
snh					
sni	Latn				
snj	Latn				
snk	Latn		Arab		
snl	Latn				
snm	Latn				
snn	Latn				
sno	Latn				
snp	Latn				
snq	Latn				
snr	Latn				
sns	Latn				
snu	Latn				
snv	Latn				
snw	Latn				
snx	Latn				
sny	Latn				
snz	Latn				
soa	Tavt, Thai				
sob	Latn				
soc	Latn				
sod	Latn				
soe	Latn				
sog	Mani, Sogd, Sogo, Syrc				
soh					
soi	Deva				
soj					
sok	Latn				
sol	Latn				
som	Latn, Arab, Osma	Borama, Kaddare			
soo	Latn				
sop	Latn				
soq	Latn				
sor	Latn				
sos	Latn				
sot	Latn	Ditema, Brai			
sou	Thai	Brai			
sov	Latn				
sow	Latn				
sox	Latn				
soy	Latn				
soz	Latn				
spa	Latn, Brai		Dupl		
spb	Latn				
spc	Latn				
spd	Latn				
spe	Latn				
spg	Latn				
spi	Latn				
spk	Latn				
spl	Latn				
spm	Latn				
spn	Latn				
spo	Latn				
spp	Latn				
spq	Latn				
spr	Latn				
sps	Latn				
spt	Tibt				
spu					
spv	Orya				
spx					
spy	Latn				
sqa	Latn				
sqh	Latn				
sqi	Brai, Latn, Elba		Vith, Grek		
sqk	Zxxx				
sqm	Latn				
sqn					
sqo	Arab				
sqq	Laoo				
sqr	Arab				
sqs	Zxxx				
sqt	Arab, Latn				
squ	Latn				
sqx	Zxxx				
sra	Latn				
srb	Telu, Sora, Latn, Orya				
src	Latn				
srd	Latn				
sre	Latn				
srf	Latn				
srg	Latn				
srh	Arab				
sri	Latn				
srk	Latn				
srl	Latn				
srm	Latn				
srn	Latn				
sro	Latn				
srp	Cyrl, Latn, Brai				
srq	Latn				
srr	Latn		Arab		
srs	Latn				
srt	Latn				
sru	Latn				
srv	Latn				
srw	Latn				
srx	Deva, Takr	Sirmauri			
sry	Latn				
srz	Arab				
ssb	Latn				
ssc	Latn				
ssd	Latn				
sse	Arab, Latn				
ssf	Latn				
ssg	Latn				
ssh	Arab				
ssi	Arab				
ssj	Latn				
ssk					
ssl	Latn				
ssm	Latn				
ssn	Latn				
sso	Latn				
ssp	Zxxx				
ssq	Latn				
ssr	Zxxx				
sss	Laoo, Thai	Latn			
sst	Latn				
ssu	Latn				
ssv	Latn				
ssw	Latn	Ditema			
ssx	Latn				
ssy	Latn, Ethi				
ssz	Latn				
sta	Latn				
stb	Latn				
std					
ste	Latn				
stf	Latn				
stg	Latn				
sth	Latn				
sti	Latn	Khmr			
stj	Latn				
stk	Latn				
stl	Latn				
stm	Latn				
stn	Latn				
sto	Latn				
stp	Latn				
stq	Latn				
str	Latn				
sts	Arab				
stt	Latn				
stu	Tale, Lana				
stv	Ethi		Arab	Latn	
stw	Latn				
sty	Cyrl				
sua	Latn				
sub	Latn				
suc	Latn				
sue	Latn				
sug	Latn				
sui	Latn				
suj	Latn				
suk	Latn				
sun	Arab, Latn, Java, Sund	Kawi, Pallava, Vatteluttu			
suo	Latn				
suq	Ethi, Latn				
sur	Latn				
sus	Arab, Latn				
sut	Latn				
suu					
suv	Deva, Beng, Latn				
suw	Latn				
sux	Xsux				
suy	Latn				
suz	Deva, Sunu	Tikamuli			
sva	Geor		Cyrl, Latn		
svb	Latn				
svc	Latn				
sve	Latn				
svk	Zxxx				
svm	Latn				
svs	Latn				
svx					
swa	Arab, Latn	Brai			
swb	Arab, Latn				
swc	Arab, Latn				
swe	Latn, Brai		Runr		
swf	Latn				
swg	Latn				
swh	Arab, Latn, Brai				
swi	Hani, Shui	Latn			
swj	Latn				
swk	Latn				
swl	Zxxx				
swm	Latn				
swn					
swo	Latn				
swp	Latn				
swq	Latn				
swr	Latn				
sws	Latn				
swt	Latn				
swu	Latn				
swv	Deva			Latn	
sww	Latn				
swx	Latn				
swy	Latn				
sxb	Latn				
sxc	Grek				
sxe	Latn				
sxg					
sxk					
sxl					
sxm					
sxn	Latn				
sxo					
sxr	Latn				
sxs	Latn				
sxu	Latn		Runr		
sxw	Latn				
sya	Latn				
syb	Latn				
syc	Syrc				
syi	Latn				
syk	Latn				
syl	Beng, Latn, Sylo				
sym	Latn				
syn	Syrc				
syo	Latn				
syr	Syrc				
sys	Latn				
syw	Deva				
syx	Latn				
syy	Zxxx				
sza	Latn				
szb	Latn				
szc	Latn				
szd	Latn				
sze					
szg	Latn				
szl	Latn				
szn	Latn				
szp	Latn				
szs	Latn, Zxxx				
szv	Latn				
szw	Latn				
szy	Latn				
taa	Latn				
tab	Cyrl				
tac	Latn				
tad	Latn				
tae	Latn				
taf	Latn				
tag	Latn				
tah	Latn				
taj	Deva, Tibt	Tamyig			
tak	Latn				
tal	Latn				
tam	Gran, Arab, Brai, Latn, Taml	Kolezhuthu, Pallava, Vatteluttu			
tan	Latn				
tao	Latn				
tap	Latn				
taq	Tfng, Latn				
tar	Latn				
tas	Latn				
tat	Arab, Cyrl, Latn				
tau	Latn				
tav	Latn				
taw	Latn				
tax	Latn				
tay	Latn		Hant, Hans		
taz	Latn				
tba	Latn				
tbb	Latn				
tbc	Latn				
tbd	Latn				
tbe	Latn				
tbf	Latn				
tbg	Latn				
tbh	Latn				
tbi	Latn				
tbj	Latn				
tbk	Tagb, Latn		Hano		
tbl	Latn				
tbm	Latn				
tbn	Latn				
tbo	Latn				
tbp	Latn				
tbr					
tbs	Latn				
tbt	Latn				
tbu	Latn				
tbv	Latn				
tbw	Tagb, Latn		Hano		
tbx	Latn				
tby	Latn				
tbz	Latn				
tca	Latn				
tcb	Latn				
tcc	Latn				
tcd	Latn				
tce	Latn				
tcf	Latn				
tcg	Latn				
tch	Latn				
tci	Latn				
tck	Latn				
tcl					
tcm	Latn				
tcn	Tibt				
tco	Mymr				
tcp	Latn				
tcq	Latn				
tcs	Latn				
tct					
tcu	Latn				
tcw	Latn				
tcx	Taml				
tcy	Knda	Mlym, Tigalari		Latn	
tcz	Latn				
tda	Arab, Tfng, Latn				
tdb	Deva, Beng	Orya, Chisoi	Kthi		
tdc	Latn				
tdd	Tale				
tde	Latn				
tdf					
tdg	Deva, Tibt	Tamyig			
tdh	Deva				
tdi	Latn				
tdj	Latn				
tdk	Latn				
tdl	Latn				
tdm	Latn				
tdn	Latn				
tdo	Latn				
tdq	Latn				
tdr	Latn				
tds	Latn				
tdt	Latn				
tdv	Latn				
tdx	Latn	Arab, Brai			
tdy	Latn				
tea	Latn				
teb	Latn				
tec	Latn				
ted	Latn				
tee	Latn				
tef					
teg	Latn				
teh	Latn				
tei	Latn				
tek	Latn				
tel	Telu, Brai			Latn	
tem	Latn				
ten	Latn				
teo	Latn				
tep	Latn				
teq	Latn				
ter	Latn				
tes	Java				
tet	Latn				
teu	Latn				
tev	Latn				
tew	Latn				
tex	Latn				
tey	Latn				
tez	Tfng, Latn				
tfi	Latn				
tfn	Latn				
tfo	Latn				
tfr	Latn				
tft	Latn				
tga	Latn				
tgb	Latn				
tgc	Latn				
tgd	Latn				
tge	Deva				
tgf	Tibt				
tgh	Latn				
tgi	Latn				
tgj	Latn				
tgk	Arab, Cyrl, Hebr, Latn				
tgl	Tglg, Brai, Latn, Buhd, Hano				
tgn	Latn				
tgo	Latn				
tgp	Latn				
tgq	Latn				
tgr					
tgs	Latn				
tgt	Tagb, Latn		Hano		
tgu	Latn				
tgv	Latn				
tgw	Latn				
tgx	Latn				
tgy	Latn				
tgz	Latn				
tha	Thai, Brai	Khom Thai		Latn	
thc					
thd	Latn				
the	Deva				
thf	Deva				
thh	Latn				
thi	Tale				
thk	Latn				
thl	Deva				
thm	Thai				
thn					
thp	Dupl, Latn				
thq	Deva				
thr	Deva				
ths	Deva				
tht	Latn				
thu	Latn				
thv	Arab, Tfng, Latn				
thw					
thy	Latn				
thz	Tfng, Latn				
tia					
tic	Latn				
tif	Latn				
tig	Arab, Ethi		Latn		
tih	Latn				
tii	Latn				
tij	Deva				
tik	Latn				
til	Latn				
tim	Latn				
tin	Cyrl				
tio	Latn				
tip	Latn				
tiq	Latn				
tir	Ethi		Arab	Latn	
tis	Latn				
tit	Latn				
tiu	Latn				
tiv	Latn				
tiw	Latn				
tix	Latn				
tiy	Latn				
tiz					
tja	Latn				
tjg	Latn				
tji	Latn				
tjj	Latn				
tjl	Mymr				
tjm	Latn				
tjn	Latn				
tjo	Arab				
tjp	Latn				
tjs	Latn				
tju	Latn				
tjw	Latn				
tka	Latn				
tkb	Deva				
tkd	Latn				
tke	Latn				
tkf	Latn				
tkg	Latn				
tkk					
tkl	Latn				
tkm					
tkn					
tkp	Latn				
tkq	Latn				
tkr	Cyrl, Latn				
tks	Arab				
tkt	Deva				
tku	Latn				
tkv	Latn				
tkw	Latn				
tkx	Latn				
tkz	Latn				
tla	Latn				
tlb	Latn				
tlc	Latn				
tld	Latn				
tlf	Latn				
tlg	Latn				
tlh	Piqd, Latn				
tli	Latn, Cyrl				
tlj	Latn				
tlk	Latn				
tll	Latn				
tlm	Latn				
tln	Latn				
tlo					
tlp	Latn				
tlq	Latn				
tlr	Latn				
tls	Latn				
tlt	Latn				
tlu	Latn				
tlv	Latn				
tlx	Latn				
tly	Arab, Cyrl, Latn				
tlz					
tma	Latn				
tmb	Latn				
tmc	Latn				
tmd	Latn				
tme	Latn				
tmf	Latn				
tmg	Latn				
tmh	Arab, Tfng, Latn				
tmi	Latn				
tmj	Latn				
tmk	Deva				
tml	Latn				
tmm	Latn				
tmn	Latn				
tmo	Latn				
tmp					
tmq	Latn				
tmr	Syrc				
tms					
tmt	Latn				
tmu	Latn				
tmv	Latn				
tmw	Latn				
tmy	Latn				
tmz	Latn				
tna	Latn				
tnb	Latn				
tnc	Latn				
tnd	Latn				
tnf					
tng	Latn				
tnh	Latn				
tni	Latn				
tnk	Latn				
tnl	Latn				
tnm	Latn				
tnn	Latn				
tno	Latn				
tnp	Latn				
tnq	Latn				
tnr	Latn				
tns	Latn				
tnt	Latn				
tnu					
tnv	Cakm				
tnw	Latn				
tnx	Latn				
tny	Latn				
tnz					
tob	Latn				
toc	Latn				
tod	Latn				
tof	Latn				
tog	Latn				
toh	Latn				
toi	Latn	Brai			
toj	Latn				
tok	Latn				
tol	Latn				
tom	Latn				
ton	Latn				
too	Latn				
top	Latn				
toq	Latn				
tor	Latn				
tos	Latn				
tou	Latn				
tov	Arab				
tow	Latn				
tox	Latn				
toy	Latn				
toz	Latn				
tpa	Latn				
tpc	Latn				
tpe	Beng, Latn				
tpf	Latn				
tpg	Latn				
tpi	Latn	Brai			
tpj	Latn				
tpk	Latn				
tpl	Latn				
tpm	Latn				
tpn	Latn				
tpo	Zzzz				
tpp	Latn				
tpq					
tpr	Latn				
tpt	Latn				
tpu	Khmr				
tpv	Latn				
tpw	Latn				
tpx	Latn				
tpy	Latn				
tpz	Latn				
tqb	Latn				
tql	Latn				
tqm	Latn				
tqn	Latn				
tqo	Latn				
tqp	Latn				
tqq					
tqr					
tqt	Latn				
tqu	Latn				
tqw	Latn				
tra	Arab				
trb	Latn				
trc	Latn				
trd					
tre	Latn				
trf	Latn				
trg	Hebr				
trh	Latn				
tri	Latn				
trj	Latn				
trl	Latn				
trm	Arab				
trn	Latn				
tro	Latn				
trp	Beng, Latn	Koloma			
trq	Latn				
trr	Latn				
trs	Latn				
trt	Latn				
tru	Latn, Syrc				
trv	Latn				
trw	Arab				
trx	Latn				
try	Latn				
trz	Latn				
tsa	Latn				
tsb	Latn				
tsc	Latn				
tsd	Grek				
tse	Zxxx				
tsf					
tsg	Arab, Latn				
tsh	Latn				
tsi	Latn				
tsj	Tibt				
tsk					
tsl	Latn				
tsm	Zxxx				
tsn	Latn	Brai			
tso	Latn, Brai				
tsp	Latn				
tsq	Zxxx				
tsr	Latn				
tss	Zxxx				
tst	Latn				
tsu	Latn				
tsv	Latn				
tsw	Latn				
tsx	Latn				
tsy	Zxxx				
tsz	Latn				
tta					
ttb	Latn				
ttc	Latn				
ttd	Latn				
tte	Latn				
ttf	Latn				
ttg	Latn				
tth	Laoo				
tti	Latn				
ttj	Latn				
ttk	Latn				
ttl	Latn				
ttm	Latn				
ttn	Latn				
tto	Laoo				
ttp	Latn				
ttq	Arab, Tfng				
ttr	Latn				
tts	Thai	Lana, Tai Noi			
ttt	Arab, Cyrl, Latn				
ttu	Latn				
ttv	Latn				
ttw	Latn				
tty	Latn				
ttz	Deva				
tua	Latn				
tub	Latn				
tuc	Latn				
tud	Latn				
tue	Latn				
tuf	Latn				
tug	Latn				
tuh	Latn				
tui	Latn				
tuj	Latn				
tuk	Arab, Cyrl, Latn	Brai			
tul	Latn				
tum	Latn	Mwangwego			
tun	Latn				
tuo	Latn				
tuq	Latn				
tur	Latn, Brai		Cyrl, Arab, Grek		
tus	Latn				
tuu	Latn				
tuv	Latn				
tux	Latn				
tuy	Latn				
tuz	Latn				
tva	Latn				
tvd	Latn				
tve	Latn				
tvi	Latn				
tvk	Latn				
tvl	Latn				
tvm	Latn				
tvn	Mymr				
tvo	Latn				
tvs	Latn				
tvt	Latn				
tvu	Latn				
tvw	Latn				
tvx	Latn				
tvy					
twa	Latn				
twb	Latn				
twc					
twd	Latn				
twe	Latn				
twf	Latn				
twg	Latn				
twh	Latn, Tavt				
twi	Latn				
twl	Latn				
twm	Deva				
twn	Latn				
two	Latn				
twp	Latn				
twq	Latn				
twr	Latn				
twt	Latn				
twu	Latn				
tww	Latn				
twx	Latn				
twy	Latn				
txa	Latn				
txb	Mani				
txc					
txe	Latn				
txg	Tang				
txh	Grek				
txi	Latn				
txj	Latn				
txm	Latn				
txn	Latn				
txo	Deva, Beng, Toto				
txq	Latn				
txr					
txs	Latn				
txt	Latn				
txu	Latn				
txx	Latn				
txy	Latn				
tya	Latn				
tye	Latn				
tyh	Latn				
tyi	Latn				
tyj	Zzzz, Latn				
tyl	Latn				
tyn	Latn				
typ	Latn				
tyr	Tavt				
tys	Latn				
tyt	Tavt, Latn				
tyu	Latn				
tyv	Cyrl			Latn	
tyx	Latn				
tyy	Latn				
tyz	Latn	Sawndip, Hani, Chữ Nôm			
tza	Zxxx				
tzh	Latn				
tzj	Latn				
tzl	Latn				
tzm	Arab, Tfng, Latn				
tzn	Latn				
tzo	Latn				
tzx	Latn				
uam	Latn				
uan					
uar	Latn				
uba	Latn				
ubi	Latn				
ubl	Latn				
ubr	Latn				
ubu	Latn				
uby	Cyrl, Latn				
uda	Latn				
ude	Cyrl				
udg	Mlym				
udi	Cyrl		Latn, Aghb		
udj	Latn				
udl	Latn				
udm	Cyrl		Latn		
udu	Latn				
ues	Latn				
ufi	Latn				
uga	Ugar				
ugb	Latn				
uge	Latn				
ugh	Cyrl				
ugn	Zxxx				
ugo	Thai				
ugy	Zxxx				
uha	Latn				
uhn	Latn				
uig	Arab, Cyrl, Latn				
uis	Latn				
uiv	Latn				
uji	Latn				
uka	Latn				
ukg	Latn				
ukh	Latn				
uki	Orya				
ukk	Latn				
ukl	Zxxx				
ukp	Latn				
ukq	Latn				
ukr	Cyrl, Latn	Brai			
uks	Zxxx				
uku	Latn				
ukv	Latn				
ukw	Latn				
uky	Latn				
ula	Latn				
ulb	Latn				
ulc	Cyrl				
ule	Latn				
ulf	Latn				
uli	Latn				
ulk	Latn				
ull					
ulm	Latn				
uln	Latn				
ulu	Latn				
ulw	Latn				
uly	Latn				
uma	Latn				
umb	Latn				
umc	Ital				
umd	Latn				
umg	Latn				
umi	Latn				
umm	Latn				
umn	Latn				
umo	Latn				
ump	Latn				
umr	Latn				
ums	Latn				
umu	Latn				
una	Latn				
une	Latn				
ung	Latn				
uni	Latn				
unk	Latn				
unm	Latn				
unn	Latn				
unr	Deva, Latn, Nagm, Beng, Orya				
unu	Latn				
unx	Deva, Beng, Orya				
unz	Latn				
uon	Latn				
upi	Latn				
upv	Latn				
ura	Latn				
urb	Latn				
urc	Latn				
urd	Arab, Latn, Brai	Hebr	Deva		
ure	Latn				
urf	Latn				
urg	Latn				
urh	Latn				
uri	Latn				
urk	Thai				
url					
urm	Latn				
urn	Latn				
uro	Latn				
urp	Latn				
urr	Latn				
urt	Latn				
uru	Latn				
urv	Latn				
urw	Latn				
urx	Latn				
ury	Latn				
urz	Latn				
usa	Latn				
ush	Arab				
usi	Beng, Latn				
usk	Latn				
usp	Latn				
uss	Latn				
usu	Latn				
uta	Latn				
ute	Latn				
uth	Latn				
utp	Latn				
utr	Latn				
utu	Latn				
uum	Cyrl, Grek				
uur	Latn				
uuu					
uve	Latn				
uvh	Latn				
uvl	Latn				
uwa	Latn				
uya	Latn				
uzb	Arab, Cyrl, Brai, Latn		Sogd		
uzn	Latn, Cyrl				
uzs	Arab				
vaa	Taml				
vae	Latn				
vaf	Arab				
vag	Latn				
vah	Deva	Modi		Latn	
vai	Vaii, Latn				
vaj	Latn				
val	Latn				
vam	Latn				
van	Latn				
vao	Latn				
vap	Latn				
var	Latn			Deva	
vas	Deva, Gujr				
vau	Latn				
vav	Deva, Gujr				
vay	Deva				
vbb	Latn				
vbk	Latn				
vec	Latn				
ved					
vel	Latn				
vem	Latn				
ven	Latn, Brai	Ditema			
veo	Latn				
vep	Latn				
ver	Latn				
vgr	Arab				
vgt	Zxxx				
vic	Latn				
vid	Latn				
vie	Latn, Brai	Chữ Nôm	Hani		
vif	Latn				
vig	Latn				
vil	Latn				
vin	Latn				
vis					
vit	Latn				
viv	Latn				
vjk	Deva				
vka	Latn				
vkj	Latn				
vkk	Latn				
vkl	Latn				
vkm	Latn				
vkn	Latn				
vko	Latn				
vkp	Deva, Latn				
vkt	Latn				
vku	Latn				
vky					
vkz	Latn				
vlp	Latn				
vls	Latn				
vma	Latn				
vmb	Latn				
vmc	Latn				
vmd	Knda				
vme	Latn				
vmf	Latn				
vmg	Latn				
vmh	Arab				
vmi	Latn				
vmj	Latn				
vmk	Latn				
vml	Latn				
vmm	Latn				
vmo					
vmp	Latn				
vmq	Latn				
vmr	Latn				
vms	Latn				
vmu	Latn				
vmv					
vmw	Latn		Arab		
vmx	Latn				
vmy	Latn				
vmz	Latn				
vnk	Latn				
vnm	Latn				
vnp	Latn				
vol	Latn				
vor	Latn				
vot	Cyrl, Latn				
vra	Latn				
vro	Latn				
vrs	Latn				
vrt	Latn				
vsi	Zxxx				
vsl	Zxxx				
vsv	Zxxx				
vto	Latn				
vum	Latn				
vun	Latn				
vut	Latn				
vwa	Latn, Mymr				
waa	Latn				
wab	Latn				
wac	Latn				
wad	Latn				
wae	Latn				
waf	Latn				
wag	Latn				
wah	Latn				
wai	Latn				
waj	Latn				
wal	Ethi, Latn				
wam	Latn				
wan	Latn				
wao					
wap	Latn				
waq	Latn				
war	Latn	Tglg	Brai		
was	Latn				
wat	Latn				
wau	Latn				
wav	Latn				
waw	Latn				
wax	Latn				
way	Latn				
waz	Latn				
wba	Latn				
wbb	Latn				
wbe	Latn				
wbf	Latn				
wbh	Latn				
wbi	Latn				
wbj	Latn				
wbk	Arab				
wbl	Latn, Arab, Cyrl				
wbm	Latn	Mymr, Hani			
wbp	Latn				
wbq	Telu	Deva, Knda	Arab		
wbr	Deva			Latn	
wbs	Zxxx				
wbt	Latn				
wbv	Latn				
wbw	Latn				
wca	Latn				
wci	Latn				
wdd	Latn				
wdg	Latn				
wdj	Latn				
wdk	Latn				
wdt	Latn				
wdu	Latn				
wdy	Latn				
wea					
wec	Latn				
wed	Latn				
weg	Latn				
weh	Latn				
wei	Latn				
wem	Latn	Nkoo			
weo	Latn				
wep	Latn				
wer	Latn				
wes	Latn				
wet	Latn				
weu	Latn				
wew	Latn				
wfg	Latn				
wga	Latn				
wgb	Latn				
wgg	Latn				
wgi	Latn				
wgo	Latn				
wgu	Latn				
wgy	Latn				
wha	Latn				
whg	Latn				
whk	Latn				
whu	Latn				
wib	Latn				
wic	Latn				
wie	Latn				
wif	Latn				
wig	Latn				
wih	Latn				
wii	Latn				
wij	Latn				
wik	Latn				
wil	Latn				
wim	Latn				
win	Latn				
wir	Latn				
wiu	Latn				
wiv	Latn				
wiy	Latn				
wja	Latn				
wji	Latn				
wka	Latn				
wkb					
wkd	Latn				
wkl					
wkr	Latn				
wku					
wkw	Latn				
wky	Latn				
wla	Latn				
wlc					
wle	Arab, Ethi, Latn				
wlg	Latn				
wlh	Latn				
wli	Latn				
wlk					
wll					
wlm	Latn				
wln	Latn				
wlo	Arab				
wlr	Latn				
wls	Latn				
wlu	Latn				
wlv	Latn				
wlw	Latn				
wlx	Latn				
wly					
wma	Latn				
wmb	Latn				
wmc	Latn				
wmd	Latn				
wme	Deva				
wmg					
wmh	Latn				
wmi	Latn				
wmm	Latn				
wmn	Latn				
wmo	Latn				
wms	Latn				
wmt	Latn				
wmw	Latn		Arab		
wmx	Latn				
wnb	Latn				
wnc	Latn				
wnd	Latn				
wne	Arab				
wng	Latn				
wni	Arab, Latn				
wnk	Latn				
wnm	Latn				
wnn	Latn				
wno	Latn				
wnp	Latn				
wnu	Latn				
wnw	Latn				
wny	Latn				
woa	Latn				
wob	Latn				
woc	Latn				
wod	Latn				
woe	Latn, Wole				
wof	Arab, Latn				
wog	Latn				
woi	Latn				
wok	Latn				
wol	Arab, Latn	Garay			
wom	Latn				
won	Latn				
woo	Latn				
wor	Latn				
wos	Latn				
wow	Latn				
woy					
wpc	Latn				
wra	Latn				
wrb	Latn				
wrd	Arab				
wrg	Latn				
wrh	Latn				
wri	Latn				
wrk	Latn				
wrl	Latn				
wrm	Latn				
wrn					
wro	Latn				
wrp	Latn				
wrr	Latn				
wrs	Latn				
wru	Latn				
wrv	Latn				
wrw	Latn				
wrx	Latn				
wry	Deva	Arab, Mahj		Latn	
wrz	Latn				
wsa	Latn				
wsg	Deva, Gonm, Telu, Gong				
wsi	Latn				
wsk	Latn				
wsr	Latn				
wss	Latn				
wsu	Latn				
wsv	Arab				
wtb	Latn				
wtf	Latn				
wth	Latn				
wti	Latn				
wtk	Latn				
wtm	Deva	Arab			
wtw	Bugi, Latn				
wua	Latn				
wub	Latn				
wud	Latn				
wuh					
wul	Latn				
wum	Latn				
wun	Latn				
wur	Latn				
wut	Latn				
wuu	Hant, Hans, Hani		Latn		
wuv	Latn				
wux	Latn				
wuy	Latn				
wwa	Latn				
wwb	Latn				
wwo	Latn				
wwr	Latn				
www	Latn				
wxa	Latn				
wxw	Latn				
wya	Latn				
wyb	Latn				
wyi	Latn				
wym	Latn				
wyn	Latn				
wyr	Latn				
wyy	Latn				
xaa	Latn				
xab	Latn				
xac					
xad					
xae					
xag	Aghb				
xai	Latn				
xaj	Latn				
xak	Latn				
xal	Cyrl, Mong				
xam	Latn				
xan	Ethi				
xao	Latn				
xap					
xaq					
xar	Latn				
xas	Cyrl				
xat	Latn				
xau	Latn				
xav	Latn				
xaw	Latn				
xay	Latn				
xbb	Latn				
xbc	Mani, Grek				
xbd	Latn				
xbe	Latn				
xbg	Latn				
xbi	Latn				
xbj	Latn				
xbm	Latn				
xbn	Latn				
xbo					
xbp	Latn				
xbr	Latn				
xbw	Latn				
xby	Latn				
xcb					
xcc					
xce					
xcg					
xch	Latn				
xcl	Armn				
xcm					
xcn					
xco	Arab, Chrs				
xcr	Cari				
xct	Tibt				
xcu					
xcv					
xcw					
xcy					
xda	Latn				
xdc	Grek, Latn				
xdk	Latn				
xdm					
xdo	Latn				
xdq	Cyrl				
xdy	Latn				
xeb					
xed	Latn				
xeg	Latn				
xel					
xem	Latn				
xep					
xer	Latn				
xes	Latn				
xet	Latn				
xeu	Latn				
xfa					
xga					
xgb	Latn				
xgd	Latn				
xgf					
xgg	Latn				
xgi	Latn				
xgl					
xgm	Latn				
xgr					
xgu	Latn				
xgw	Latn				
xha					
xhc					
xhd	Sarb				
xhe	Arab				
xhm	Khmr				
xho	Latn, Brai	Ditema			
xhr	Ital				
xht					
xhu					
xhv	Latn				
xib					
xii	Latn				
xil					
xin	Latn				
xir	Latn				
xis	Orya	Deva, Kurukh Banna, Tolong Siki			
xiv					
xiy	Latn				
xjb	Latn				
xjt	Latn				
xka	Arab				
xkb	Latn				
xkc	Arab				
xkd	Latn				
xke	Latn				
xkf	Tibt				
xkg	Latn				
xki	Zxxx				
xkj	Arab				
xkk					
xkl	Latn				
xkn	Latn				
xko					
xkp	Arab				
xkq	Latn				
xkr	Latn				
xks	Latn				
xkt	Latn				
xku	Latn				
xkv	Latn				
xkw	Latn				
xkx	Latn				
xky	Latn				
xkz	Tibt, Latn				
xla	Latn				
xlb					
xlc	Lyci				
xld	Lydi				
xle					
xlg					
xli					
xln					
xlo					
xlp					
xls	Latn				
xlu					
xly	Elym				
xma	Latn				
xmb	Latn				
xmc	Latn				
xmd	Latn				
xme					
xmf	Geor				
xmg	Zzzz, Latn				
xmh	Latn				
xmj	Latn				
xmk					
xml	Zxxx				
xmm	Latn				
xmn	Mani				
xmo	Latn				
xmp	Latn				
xmq	Latn				
xmr	Merc				
xms	Zxxx				
xmt	Latn				
xmu	Latn				
xmv	Latn				
xmw	Latn				
xmx	Latn				
xmy	Latn				
xmz	Latn				
xna	Narb				
xnb	Latn				
xng					
xnh					
xni	Latn				
xnj	Latn				
xnk	Latn				
xnm	Latn				
xnn	Latn				
xno					
xnq	Latn				
xnr	Deva, Takr			Latn	
xns					
xnt	Latn				
xnu	Latn				
xny	Latn				
xnz	Copt, Arab, Latn				
xoc	Latn				
xod	Latn				
xog	Latn				
xoi	Latn				
xok	Latn				
xom	Ethi, Latn				
xon	Latn, Brai				
xoo	Latn				
xop	Latn				
xor	Latn				
xow	Latn				
xpa	Latn				
xpb	Latn				
xpc					
xpd	Latn				
xpe	Kpel, Latn				
xpf	Latn				
xpg	Grek				
xph	Latn				
xpi	Ogam				
xpj	Latn				
xpk	Latn				
xpl	Latn				
xpm	Cyrl				
xpn	Latn				
xpo	Latn				
xpp					
xpq	Latn				
xpr	Prti				
xps					
xpt	Latn				
xpu	Phnx				
xpv	Latn				
xpw	Latn				
xpx	Latn				
xpy					
xpz	Latn				
xqa					
xqt					
xra	Latn				
xrb	Latn				
xrd	Latn				
xre	Latn				
xrg	Latn				
xri	Latn				
xrm	Cyrl				
xrn	Cyrl				
xrr	Latn				
xrt					
xru	Latn				
xrw	Latn				
xsa	Sarb				
xsb	Latn				
xsc					
xsd					
xse	Latn				
xsh	Latn				
xsi	Latn				
xsk					
xsm	Latn	Goulsse			
xsn	Latn				
xso					
xsp	Latn				
xsq	Latn				
xsr	Deva, Tibt				
xss	Cyrl				
xsu	Latn				
xsv					
xsy	Latn				
xta	Latn				
xtb	Latn				
xtc	Latn				
xtd	Latn				
xte	Latn				
xtg					
xth	Latn				
xti	Latn				
xtj	Latn				
xtl	Latn				
xtm	Latn				
xtn	Latn				
xto					
xtp	Latn				
xtq	Khar, Brah				
xtr					
xts	Latn				
xtt	Latn				
xtu	Latn				
xtv	Latn				
xtw	Latn				
xty	Latn				
xtz	Latn				
xua					
xub	Knda, Taml, Mlym				
xud	Latn				
xug					
xuj	Taml				
xul	Latn				
xum	Ital, Latn				
xun	Latn				
xuo	Latn				
xup					
xur					
xut	Latn				
xuu	Latn				
xve	Ital				
xvi	Arab				
xvn	Latn				
xvo	Latn				
xvs	Latn				
xwa	Latn				
xwc					
xwd	Latn				
xwe	Latn				
xwg					
xwj	Latn				
xwk	Latn				
xwl	Latn				
xwo	Cyrl				
xwr	Latn				
xwt	Latn				
xww	Latn				
xxb	Latn				
xxk	Latn				
xxm	Latn				
xxr	Latn				
xxt	Latn				
xya	Latn				
xyb	Latn				
xyj	Latn				
xyk	Latn				
xyl	Latn				
xyt	Latn				
xyy	Latn				
xzh	Marc				
xzm					
xzp	Latn				
yaa	Latn				
yab	Latn				
yac	Latn				
yad	Latn				
yae	Latn				
yaf	Latn				
yag	Latn				
yah	Arab, Cyrl, Latn				
yai	Cyrl	Latn, Arab			
yaj	Latn				
yak	Latn				
yal	Latn		Arab		
yam	Latn				
yan	Latn				
yao	Latn		Arab		
yap	Latn				
yaq	Latn				
yar	Latn				
yas	Latn				
yat	Latn				
yau	Latn				
yav	Latn				
yaw	Latn				
yax	Latn				
yay	Latn				
yaz	Latn				
yba	Latn				
ybb	Latn				
ybd					
ybe	Ougr, Latn				
ybh	Deva				
ybi	Deva				
ybj	Latn				
ybk					
ybl	Latn				
ybm	Latn				
ybn	Latn				
ybo	Latn				
ybx	Latn				
yby	Latn				
ych					
ycl	Latn				
ycn	Latn				
ycp					
ycr	Latn				
yda	Latn				
ydd	Hebr				
yde	Latn				
ydg	Arab				
ydk	Latn				
yea	Knda, Mlym				
yec	Latn				
yee	Latn				
yei	Latn				
yej	Grek				
yel	Latn				
yer	Latn				
yes	Latn				
yet	Latn				
yeu	Telu				
yev	Latn				
yey	Latn				
yga	Latn				
ygi	Latn				
ygl	Latn				
ygm	Latn				
ygp	Plrd				
ygr	Latn				
ygs	Zxxx				
ygu	Latn				
ygw	Latn				
yha					
yhd	Hebr				
yhl					
yhs	Zxxx				
yia	Latn				
yid	Hebr, Latn				
yif					
yig	Yiii				
yih	Hebr				
yii	Latn				
yij	Latn				
yik					
yil	Latn				
yim	Latn				
yin					
yio					
yip					
yiq					
yir	Latn				
yis	Latn				
yit					
yiu					
yiv	Yiii				
yix					
yiz					
yka	Latn		Arab		
ykg	Cyrl				
ykh	Cyrl				
yki	Latn				
ykk	Latn				
ykl					
ykm	Latn				
ykn					
yko	Latn				
ykr	Latn				
ykt					
yku					
yky	Latn				
yla	Latn				
ylb	Latn				
yle	Latn				
ylg	Latn				
yli	Latn				
yll	Latn				
ylm					
yln					
ylo					
ylr	Latn				
ylu	Latn				
yly	Latn				
ymb	Latn				
ymc					
ymd					
yme	Latn				
ymg	Latn				
ymh					
ymi					
ymk	Arab, Latn				
yml	Latn				
ymm	Latn				
ymn	Latn				
ymo	Latn				
ymp	Latn				
ymq					
ymr					
yms					
ymx					
ymz					
yna	Plrd				
ynd	Latn				
yne					
yng	Latn				
ynk	Cyrl				
ynl	Latn				
ynn					
yno	Latn				
ynq	Latn				
yns	Latn				
ynu	Latn				
yob	Latn				
yog	Latn				
yoi	Jpan				
yok	Latn				
yol	Latn				
yom	Latn	Mandombe			
yon	Latn				
yor	Arab, Latn, Brai	Oduduwa			
yos					
yot	Latn				
yox					
yoy	Thai				
ypa					
ypb					
ypg					
yph					
ypm					
ypn					
ypo					
ypp					
ypz					
yra	Latn				
yrb	Latn				
yre	Latn				
yrk	Cyrl				
yrl	Latn, Latn				
yrm	Latn				
yrn					
yro	Latn				
yrs	Latn				
yrw	Latn				
yry	Latn				
ysc					
ysd	Yiii				
ysg					
ysl	Zxxx				
ysm	Zxxx				
ysn	Yiii				
yso					
ysp	Yiii				
ysr	Cyrl				
yss	Latn				
ysy	Plrd				
yta					
ytl					
ytp					
ytw	Latn				
yty	Latn				
yua	Latn				
yub	Latn				
yuc	Latn				
yud	Hebr				
yue	Hant, Hans, Hani		Latn, Brai		
yuf	Latn				
yug	Cyrl				
yui	Latn				
yuj	Latn				
yuk					
yul	Latn				
yum	Latn				
yun	Latn				
yup	Latn				
yuq	Latn				
yur	Latn				
yut	Latn				
yuw	Latn				
yux	Cyrl				
yuy					
yuz	Latn				
yva	Latn				
yvt	Latn				
ywa	Latn				
ywg	Latn				
ywl					
ywm					
ywn	Latn				
ywq	Plrd, Yiii				
ywr	Latn				
ywt					
ywu	Yiii, Plrd				
yww	Latn				
yxa	Latn				
yxg	Latn				
yxl	Latn				
yxm	Latn				
yxu	Latn				
yxy	Latn				
yym					
yyr	Latn				
yyu	Latn				
yyz					
yzg					
yzk					
zaa	Latn				
zab	Latn				
zac	Latn				
zad	Latn				
zae	Latn				
zaf	Latn				
zag	Latn	Zaghawa	Arab		
zah	Latn				
zai	Latn				
zaj	Latn				
zak	Latn				
zal					
zam	Latn				
zao	Latn				
zap	Latn				
zaq	Latn				
zar	Latn				
zas	Latn				
zat	Latn				
zau	Arab, Tibt				
zav	Latn				
zaw	Latn				
zax	Latn				
zay	Ethi, Latn				
zaz	Latn				
zba	Arab				
zbc	Latn				
zbe	Latn				
zbl	Blis				
zbt	Latn				
zbu	Latn				
zbw	Latn				
zca	Latn				
zch	Hani				
zdj	Arab, Latn				
zea	Latn				
zeg	Latn				
zeh	Hani				
zem	Latn				
zen	Arab, Tfng				
zga	Latn				
zgb	Hani				
zgh	Tfng				
zgm	Hani				
zgn	Hani				
zgr	Latn				
zha	Hani, Hans, Latn	Sawndip, Sawgoek			
zhb					
zhd	Hani, Latn				
zhi	Latn				
zhn	Hani, Latn				
zho	Hanb, Arab, Brai, Bopo, Latn, Hant, Phag, Hans, Hani				
zhw	Latn				
zhx	Nshu				
zia	Latn				
zib	Zxxx				
zik	Latn				
zil	Latn				
zim	Latn				
zin	Latn				
ziw	Latn				
ziz	Latn				
zka	Latn				
zkb	Cyrl				
zkd	Latn				
zkg					
zkh					
zkk					
zkn					
zko	Cyrl				
zkp	Latn				
zkr					
zkt	Kitl, Kits				
zku	Latn				
zkv					
zkz	Cyrl				
zla	Latn				
zlj	Hani, Latn				
zlm	Arab, Latn				
zln	Hani				
zlq	Hani				
zlu	Latn				
zma	Latn				
zmb	Latn				
zmc	Latn				
zmd	Latn				
zme	Latn				
zmf	Latn				
zmg	Latn				
zmh	Latn				
zmi	Latn				
zmj	Latn				
zmk	Latn				
zml	Latn				
zmm	Latn				
zmn	Latn				
zmo	Latn				
zmp	Latn				
zmq	Latn				
zmr	Latn				
zms	Latn				
zmt	Latn				
zmu	Latn				
zmv	Latn				
zmw	Latn				
zmx	Latn				
zmy	Latn				
zmz	Latn				
zna	Latn				
zne	Latn		Arab		
zng	Latn				
znk	Latn				
zns	Latn				
zoc	Latn				
zoh	Latn				
zom	Latn	Zoulai			
zoo	Latn				
zoq	Latn				
zor	Latn				
zos	Latn				
zpa	Latn				
zpb	Latn				
zpc	Latn				
zpd	Latn				
zpe	Latn				
zpf	Latn				
zpg	Latn				
zph	Latn				
zpi	Latn				
zpj	Latn				
zpk	Latn				
zpl	Latn				
zpm	Latn				
zpn	Latn				
zpo	Latn				
zpp	Latn				
zpq	Latn				
zpr	Latn				
zps	Latn				
zpt	Latn				
zpu	Latn				
zpv	Latn				
zpw	Latn				
zpx	Latn				
zpy	Latn				
zpz	Latn				
zqe	Hani, Latn				
zra					
zrg	Telu, Orya				
zrn	Latn				
zro	Latn				
zrp	Hebr				
zrs	Latn				
zsa	Latn				
zsk					
zsl	Zxxx				
zsm	Brai, Latn				
zsr	Latn				
zsu	Latn				
zte	Latn				
ztg	Latn				
ztl	Latn				
ztm	Latn				
ztn	Latn				
ztp	Latn				
ztq	Latn				
zts	Latn				
ztt	Latn				
ztu	Latn				
ztx	Latn				
zty	Latn				
zua	Latn				
zuh	Latn				
zul	Latn, Brai	Ditema			
zum	Arab				
zun	Latn				
zuy	Latn				
zwa	Ethi				Latn
zyb	Latn				
zyg	Hani, Nshu				
zyj	Hani, Latn	Sawndip			
zyn	Hani				
zyp	Latn				
zza	Latn		Arab		
zzj	Hani				
